TATTACAATACTCCCTCAAGTCTA -> ATTACAATACTCCCTCAAGTCTAG
ACAGCCGGCCTTTGGAAACTGCTC -> CAGCCGGCCTTTGGAAACTGCTCG
GGTCTTCATAAGTGTCTATACAGG -> GTCTTCATAAGTGTCTATACAGGA
AGGCGGGAGCGCCACAGTTGAATT -> GGCGGGAGCGCCACAGTTGAATTG
AGGATCGGCACGTGGTGGGACCAC -> GGATCGGCACGTGGTGGGACCACT
AAGGCCACTATACGCCCGGTAGAA -> AGGCCACTATACGCCCGGTAGAAG
ATAAACGGTGAAGCTTACAGCCAT -> TAAACGGTGAAGCTTACAGCCATT
CGACAGCTTTTCGTAACATTTCTC -> GACAGCTTTTCGTAACATTTCTCC
GCTTTAAATGTTAGCCGGTTTGAA -> CTTTAAATGTTAGCCGGTTTGAAC
TGAATTTTGTCGATCAGGGTGTAG -> GAATTTTGTCGATCAGGGTGTAGT
TTGGAAGTGCGATACCGTGGCCGG -> TGGAAGTGCGATACCGTGGCCGGT
CGAAGTCGGCCTTATTCCCTCGTT -> GAAGTCGGCCTTATTCCCTCGTTC
GATAAACGGTGAAGCTTACAGCCA -> ATAAACGGTGAAGCTTACAGCCAT
TGATTGTATTTCTAGTTCCCTGTG -> GATTGTATTTCTAGTTCCCTGTGC
CGCTAAAGACTTATAGTGTCTTCA -> GCTAAAGACTTATAGTGTCTTCAC
GGTCGGGCCTGCTCGCCAACTCGC -> GTCGGGCCTGCTCGCCAACTCGCC
CTTGAGGTCGTCTGGTCGACAAAT -> TTGAGGTCGTCTGGTCGACAAATC
CGCTCCGTACAAGCCCATTGGAGA -> GCTCCGTACAAGCCCATTGGAGAT
AAATGTTAGCCGGTTTGAACGCCG -> AATGTTAGCCGGTTTGAACGCCGA
TTACTACCGCGACAGCTTTTCGTA -> TACTACCGCGACAGCTTTTCGTAA
GAGGTCGTCTGGTCGACAAATCTC -> AGGTCGTCTGGTCGACAAATCTCC
AAAGTAAGAGATCCGGATTGTGAG -> AAGTAAGAGATCCGGATTGTGAGG
TAATCCAGTCATGCTGGGGTCGGG -> AATCCAGTCATGCTGGGGTCGGGC
GCCCTGTAAAGTAAGAGATCCGGA -> CCCTGTAAAGTAAGAGATCCGGAT
GACTTCGTTCCCCCACATCGCTAA -> ACTTCGTTCCCCCACATCGCTAAA
CTCCTGACGCTAACTTACTAAGCC -> TCCTGACGCTAACTTACTAAGCCG
AACCTCTTAACGGTTCAAGAGCTA -> ACCTCTTAACGGTTCAAGAGCTAA
ATCTGTAGAACATTGGAAGACCTC -> TCTGTAGAACATTGGAAGACCTCG
GCTAACTTACTAAGCCGGTACGTC -> CTAACTTACTAAGCCGGTACGTCC
GAGCAGCTCTACGTGGCCGTGTTC -> AGCAGCTCTACGTGGCCGTGTTCA
TTAGTGATTGTATTTCTAGTTCCC -> TAGTGATTGTATTTCTAGTTCCCT
TCACGTCCATGAGAACGCCTCATC -> CACGTCCATGAGAACGCCTCATCT
CACCTTAGCATAAGTACGCTTCAC -> ACCTTAGCATAAGTACGCTTCACC
AAACGACATGACTCCAATCAGGTG -> AACGACATGACTCCAATCAGGTGC
CCAAGGCTGGCGCGATAGTAGATG -> CAAGGCTGGCGCGATAGTAGATGA
AGTAACTCCTGGTCGCTCCGTACA -> GTAACTCCTGGTCGCTCCGTACAA
CGCTGGCGGCTCCTGACGCTAACT -> GCTGGCGGCTCCTGACGCTAACTT
CGGCAGGGTGCTGTTAAAGCTGGT -> GGCAGGGTGCTGTTAAAGCTGGTC
GTCTGTCAGTGGTGTGCTCGAATA -> TCTGTCAGTGGTGTGCTCGAATAG
AGGATAAACCCTACAGCACAACGT -> GGATAAACCCTACAGCACAACGTC
GGTTCAAGAGCTAACCCCCCAATA -> GTTCAAGAGCTAACCCCCCAATAT
TTGAATATAATGCCACAACAGAAG -> TGAATATAATGCCACAACAGAAGT
AGCGCATGGCACCTTTAGACTCCC -> GCGCATGGCACCTTTAGACTCCCG
CCTGCTCGCCAACTCGCCAATTCC -> CTGCTCGCCAACTCGCCAATTCCG
TTAAAGCTGGTCGAGTGAAGGCCT -> TAAAGCTGGTCGAGTGAAGGCCTA
CATAAGTGTCTATACAGGATTGCG -> ATAAGTGTCTATACAGGATTGCGG
TGTGTCCTGTGTCAGCAACACTTG -> GTGTCCTGTGTCAGCAACACTTGG
ACATGTATTCTGTCAACCGGGATG -> CATGTATTCTGTCAACCGGGATGT
CTTGGTGCCTCTACAGCCGGCCTT -> TTGGTGCCTCTACAGCCGGCCTTT
ACGATAATCCAGTCATGCTGGGGT -> CGATAATCCAGTCATGCTGGGGTC
AAGTCGGCATGCCTGGCTTAGGGT -> AGTCGGCATGCCTGGCTTAGGGTT
TGGACTTACAGACTGTTTAAGGTT -> GGACTTACAGACTGTTTAAGGTTA
AGAATTCTCGAAGCAGCGGTCTGT -> GAATTCTCGAAGCAGCGGTCTGTC
TGATGTGTCCTGTGTCAGCAACAC -> GATGTGTCCTGTGTCAGCAACACT
AACTCCTGGTCGCTCCGTACAAGC -> ACTCCTGGTCGCTCCGTACAAGCC
ACAGCCATTGACGCCATACGTCCG -> CAGCCATTGACGCCATACGTCCGT
CAATTCCGTTTAAGTCGCCAAGAT -> AATTCCGTTTAAGTCGCCAAGATC
TTAACGGTTCAAGAGCTAACCCCC -> TAACGGTTCAAGAGCTAACCCCCC
AGACTTATAGTGTCTTCACGTCCA -> GACTTATAGTGTCTTCACGTCCAT
ACGACCGAGCGCATGGCACCTTTA -> CGACCGAGCGCATGGCACCTTTAG
CACTTGCAACTGAACTTTCGAAAG -> ACTTGCAACTGAACTTTCGAAAGC
ACGTTTGTTGTAACTGAAATGAAA -> CGTTTGTTGTAACTGAAATGAAAT
TTCGTAACATTTCTCCGACGCCGA -> TCGTAACATTTCTCCGACGCCGAT
TTTGCGCCCTTGGTGCCTCTACAG -> TTGCGCCCTTGGTGCCTCTACAGC
CCTCAAGTCTAGGGAATTATCGTC -> CTCAAGTCTAGGGAATTATCGTCA
ACGACCGCTCATGGTACGACCGAG -> CGACCGCTCATGGTACGACCGAGC
GCTTCTCCCCCCCCTTTCGAATTT -> CTTCTCCCCCCCCTTTCGAATTTT
GTGCTTCGCCCGTTCTTCTGTGGT -> TGCTTCGCCCGTTCTTCTGTGGTA
AGTGCGATACCGTGGCCGGTCATT -> GTGCGATACCGTGGCCGGTCATTA
ACTGCTCGTTCTCTGCTTTAAATG -> CTGCTCGTTCTCTGCTTTAAATGT
TCCCAACTAGAGACCGCCGTCAAA -> CCCAACTAGAGACCGCCGTCAAAC
TGAATATAGAGATGAGGATCGGCA -> GAATATAGAGATGAGGATCGGCAC
CAATATCCTGGACTTACAGACTGT -> AATATCCTGGACTTACAGACTGTT
CCTACAGCACAACGTCCCAACTAG -> CTACAGCACAACGTCCCAACTAGA
GTCTGGTCGACAAATCTCCGTAAC -> TCTGGTCGACAAATCTCCGTAACT
AGTCGGCATGCCTGGCTTAGGGTT -> GTCGGCATGCCTGGCTTAGGGTTT
TCACTAGTGATGTGTCCTGTGTCA -> CACTAGTGATGTGTCCTGTGTCAG
TGTTCTTCGTTATTACAATACTCC -> GTTCTTCGTTATTACAATACTCCC
CCGGCCTTTGGAAACTGCTCGTTC -> CGGCCTTTGGAAACTGCTCGTTCT
GGCGCGATAGTAGATGAGTGCAAT -> GCGCGATAGTAGATGAGTGCAATA
AACACTTGGAAGTGCGATACCGTG -> ACACTTGGAAGTGCGATACCGTGG
GCTTCGCCCGTTCTTCTGTGGTAA -> CTTCGCCCGTTCTTCTGTGGTAAC
TGTGTCATACCAATAGAAAAATCA -> GTGTCATACCAATAGAAAAATCAG
ATTGGAAGACCTCGCAAATGAATA -> TTGGAAGACCTCGCAAATGAATAT
CTCCCCCCCCTTTCGAATTTTCAA -> TCCCCCCCCTTTCGAATTTTCAAG
GAATATAGAGATGAGGATCGGCAC -> AATATAGAGATGAGGATCGGCACG
GGCCACGATAATCCAGTCATGCTG -> GCCACGATAATCCAGTCATGCTGG
ACCACCTTAGCATAAGTACGCTTC -> CCACCTTAGCATAAGTACGCTTCA
GTAGTCGCCTCCTCACCCGATAGG -> TAGTCGCCTCCTCACCCGATAGGA
GGGACGAAGTCGGCCTTATTCCCT -> GGACGAAGTCGGCCTTATTCCCTC
TCAGCCAGAAGATTGTATGCGGCC -> CAGCCAGAAGATTGTATGCGGCCC
AGCGGTCTGTCAGTGGTGTGCTCG -> GCGGTCTGTCAGTGGTGTGCTCGA
TCCGGGCGAGTCCGGCATGTTAGA -> CCGGGCGAGTCCGGCATGTTAGAG
CGTTACGGAACCGGAACGTAGAAG -> GTTACGGAACCGGAACGTAGAAGG
AAGAGAGCTTACCCTATCTACATT -> AGAGAGCTTACCCTATCTACATTT
CCTCTTAACGGTTCAAGAGCTAAC -> CTCTTAACGGTTCAAGAGCTAACC
TCCCATCAACCTTGCTTTATCCTC -> CCCATCAACCTTGCTTTATCCTCT
CTATACAGGATTGCGGTGTGCTTG -> TATACAGGATTGCGGTGTGCTTGA
ATACTCCCTCAAGTCTAGGGAATT -> TACTCCCTCAAGTCTAGGGAATTA
AAATCTCCGTAACTTCAAGCCGTG -> AATCTCCGTAACTTCAAGCCGTGT
GGCCGGTCATTAAAAGCGCTGCCC -> GCCGGTCATTAAAAGCGCTGCCCT
TTCACATGGATGTTACTAGACGCG -> TCACATGGATGTTACTAGACGCGA
TCCCTGTGCATCAGTGAATTTTGT -> CCCTGTGCATCAGTGAATTTTGTC
ATCGTCACTAGTGATGTGTCCTGT -> TCGTCACTAGTGATGTGTCCTGTG
GAGAGCTTACCCTATCTACATTTA -> AGAGCTTACCCTATCTACATTTAC
ATGTATTCTGTCAACCGGGATGTA -> TGTATTCTGTCAACCGGGATGTAC
GTCTGGGACGAAGTCGGCCTTATT -> TCTGGGACGAAGTCGGCCTTATTC
CTGCATCCTGATGTGTCATACCAA -> TGCATCCTGATGTGTCATACCAAT
CCCTTGGTGCCTCTACAGCCGGCC -> CCTTGGTGCCTCTACAGCCGGCCT
CAACCTCCCGGACTGTAGTAACTC -> AACCTCCCGGACTGTAGTAACTCC
CATTTCAAAGGCCACTATACGCCC -> ATTTCAAAGGCCACTATACGCCCG
ACATTGGAAGACCTCGCAAATGAA -> CATTGGAAGACCTCGCAAATGAAT
ATACGTCCGTGCTTCGCCCGTTCT -> TACGTCCGTGCTTCGCCCGTTCTT
CCTTATTCCCTCGTTCAACACAGA -> CTTATTCCCTCGTTCAACACAGAT
GAATAGCATAAATTCGAACACGAC -> AATAGCATAAATTCGAACACGACC
CATCTTCACGTATCTGTAGAACAT -> ATCTTCACGTATCTGTAGAACATT
AACGGGTCTACGGCCACGATAATC -> ACGGGTCTACGGCCACGATAATCC
GCACCCGTGGTACAACCTCCCGGA -> CACCCGTGGTACAACCTCCCGGAC
GAGTGCAATATGAAGTCGGCAGGG -> AGTGCAATATGAAGTCGGCAGGGT
GGTAATACCCCAAGGCTGGCGCGA -> GTAATACCCCAAGGCTGGCGCGAT
TACTAGACGCGAATGTCGTTTGCG -> ACTAGACGCGAATGTCGTTTGCGC
ACGCCCGGTAGAAGTCTGAATTTA -> CGCCCGGTAGAAGTCTGAATTTAG
AATCTCCGTAACTTCAAGCCGTGT -> ATCTCCGTAACTTCAAGCCGTGTG
AACTAGAGTCCATAAACATGTTCT -> ACTAGAGTCCATAAACATGTTCTT
ATACCCTTGTCTGGGACGAAGTCG -> TACCCTTGTCTGGGACGAAGTCGG
GAAAGCGATCCAACCTAGACCCGT -> AAAGCGATCCAACCTAGACCCGTG
TGCTGCAAGCTTAGCAGGCCACAT -> GCTGCAAGCTTAGCAGGCCACATG
TCCTGATGTGTCATACCAATAGAA -> CCTGATGTGTCATACCAATAGAAA
TGGTAACTAGAGTCCATAAACATG -> GGTAACTAGAGTCCATAAACATGT
GATCCAACCTAGACCCGTGCTTAG -> ATCCAACCTAGACCCGTGCTTAGA
TTCGTTATTACAATACTCCCTCAA -> TCGTTATTACAATACTCCCTCAAG
GGCATGCCTGGCTTAGGGTTTCAC -> GCATGCCTGGCTTAGGGTTTCACT
GGATTGTGAGGGCGTCAATATCCT -> GATTGTGAGGGCGTCAATATCCTG
GCTGGTCGAGTGAAGGCCTATCCG -> CTGGTCGAGTGAAGGCCTATCCGA
CGGCCACGATAATCCAGTCATGCT -> GGCCACGATAATCCAGTCATGCTG
TTAGGGTTTCACTATCTCGTTACG -> TAGGGTTTCACTATCTCGTTACGG
GTGATTGTATTTCTAGTTCCCTGT -> TGATTGTATTTCTAGTTCCCTGTG
CTACCGCGACAGCTTTTCGTAACA -> TACCGCGACAGCTTTTCGTAACAT
GTATGCGGCCCCATTCCCATCAAC -> TATGCGGCCCCATTCCCATCAACC
CTTCAAGCCGTGTGACTTCGTTCC -> TTCAAGCCGTGTGACTTCGTTCCC
ACATCGCTAAAGACTTATAGTGTC -> CATCGCTAAAGACTTATAGTGTCT
TTCACGTATCTGTAGAACATTGGA -> TCACGTATCTGTAGAACATTGGAA
TGTTGTAACTGAAATGAAATTCCT -> GTTGTAACTGAAATGAAATTCCTA
GCAATTAGGCGGGAGCGCCACAGT -> CAATTAGGCGGGAGCGCCACAGTT
CGTCCAATACGGACGTTTGTTGTA -> GTCCAATACGGACGTTTGTTGTAA
TGAATTTAGGGGGTTACAAACTTG -> GAATTTAGGGGGTTACAAACTTGA
ATGCCGTCGCTCCGGAACGGGTCT -> TGCCGTCGCTCCGGAACGGGTCTA
CGTGTTCACATGGATGTTACTAGA -> GTGTTCACATGGATGTTACTAGAC
TGTGAGGGCGTCAATATCCTGGAC -> GTGAGGGCGTCAATATCCTGGACT
AGAAAAATCAGAGCATCCCTAAGC -> GAAAAATCAGAGCATCCCTAAGCT
CTGTCAACCGGGATGTACGCTGGC -> TGTCAACCGGGATGTACGCTGGCG
CAATACGGACGTTTGTTGTAACTG -> AATACGGACGTTTGTTGTAACTGA
GCTGGGGTCGGGCCTGCTCGCCAA -> CTGGGGTCGGGCCTGCTCGCCAAC
CGCATGGCACCTTTAGACTCCCGA -> GCATGGCACCTTTAGACTCCCGAC
CTGTAGTAACTCCTGGTCGCTCCG -> TGTAGTAACTCCTGGTCGCTCCGT
CGTTTGCGCCCTTGGTGCCTCTAC -> GTTTGCGCCCTTGGTGCCTCTACA
TATAATGCCACAACAGAAGTCGGC -> ATAATGCCACAACAGAAGTCGGCA
GTAACATTTCTCCGACGCCGATTG -> TAACATTTCTCCGACGCCGATTGT
GGGGTCGGGCCTGCTCGCCAACTC -> GGGTCGGGCCTGCTCGCCAACTCG
GTACAAGCCCATTGGAGATGCCGT -> TACAAGCCCATTGGAGATGCCGTC
ACTTGGAAGTGCGATACCGTGGCC -> CTTGGAAGTGCGATACCGTGGCCG
ATAACACTTGCAACTGAACTTTCG -> TAACACTTGCAACTGAACTTTCGA
CCGAGCGCATGGCACCTTTAGACT -> CGAGCGCATGGCACCTTTAGACTC
CGCCATACGTCCGTGCTTCGCCCG -> GCCATACGTCCGTGCTTCGCCCGT
CCATTTCAAAGGCCACTATACGCC -> CATTTCAAAGGCCACTATACGCCC
AATTCCTAATCCCAAGCCATACTC -> ATTCCTAATCCCAAGCCATACTCC
CCGTGGCCGGTCATTAAAAGCGCT -> CGTGGCCGGTCATTAAAAGCGCTG
TATGCACCCGTGGTACAACCTCCC -> ATGCACCCGTGGTACAACCTCCCG
ATCCCAAGCCATACTCCGCTTCTC -> TCCCAAGCCATACTCCGCTTCTCC
ATTATCGTCACTAGTGATGTGTCC -> TTATCGTCACTAGTGATGTGTCCT
TCATTAAAAGCGCTGCCCTGTAAA -> CATTAAAAGCGCTGCCCTGTAAAG
CCGGACTGTAGTAACTCCTGGTCG -> CGGACTGTAGTAACTCCTGGTCGC
TTAGGGGGTTACAAACTTGAACCT -> TAGGGGGTTACAAACTTGAACCTC
AACCGGAACGTAGAAGGTAATACC -> ACCGGAACGTAGAAGGTAATACCC
ATGCCACAACAGAAGTCGGCATGC -> TGCCACAACAGAAGTCGGCATGCC
ATATAGAGATGAGGATCGGCACGT -> TATAGAGATGAGGATCGGCACGTG
TAGTGATGTGTCCTGTGTCAGCAA -> AGTGATGTGTCCTGTGTCAGCAAC
TTCTAGTTCCCTGTGCATCAGTGA -> TCTAGTTCCCTGTGCATCAGTGAA
TACGCTTCACCCTATGCACCCGTG -> ACGCTTCACCCTATGCACCCGTGG
CTTAGCATAAGTACGCTTCACCCT -> TTAGCATAAGTACGCTTCACCCTA
ACGACATGACTCCAATCAGGTGCT -> CGACATGACTCCAATCAGGTGCTT
TTGAGGTCGTCTGGTCGACAAATC -> TGAGGTCGTCTGGTCGACAAATCT
AAGTGACATGACCTTGAGGTCGTC -> AGTGACATGACCTTGAGGTCGTCT
TCACATGGATGTTACTAGACGCGA -> CACATGGATGTTACTAGACGCGAA
TAGACGCGAATGTCGTTTGCGCCC -> AGACGCGAATGTCGTTTGCGCCCT
TATGCGGCCCCATTCCCATCAACC -> ATGCGGCCCCATTCCCATCAACCT
GTGAAGCTTACAGCCATTGACGCC -> TGAAGCTTACAGCCATTGACGCCA
ATCCGGATTGTGAGGGCGTCAATA -> TCCGGATTGTGAGGGCGTCAATAT
AAGCAGCGGTCTGTCAGTGGTGTG -> AGCAGCGGTCTGTCAGTGGTGTGC
CGTCCATGAGAACGCCTCATCTTT -> GTCCATGAGAACGCCTCATCTTTC
AAAGTCCGCCGGCGACTGATAACA -> AAGTCCGCCGGCGACTGATAACAC
GAAGGTAATACCCCAAGGCTGGCG -> AAGGTAATACCCCAAGGCTGGCGC
TTGTGAGGGCGTCAATATCCTGGA -> TGTGAGGGCGTCAATATCCTGGAC
TCCCGACAGCCCGTAAAAGCATCT -> CCCGACAGCCCGTAAAAGCATCTT
GTCTTCATAAGTGTCTATACAGGA -> TCTTCATAAGTGTCTATACAGGAT
GTAGAAGTCTGAATTTAGGGGGTT -> TAGAAGTCTGAATTTAGGGGGTTA
ATTGTATTTCTAGTTCCCTGTGCA -> TTGTATTTCTAGTTCCCTGTGCAT
TCGAATAGCATAAATTCGAACACG -> CGAATAGCATAAATTCGAACACGA
GCATGCCTGGCTTAGGGTTTCACT -> CATGCCTGGCTTAGGGTTTCACTA
TAAAGTAAGAGATCCGGATTGTGA -> AAAGTAAGAGATCCGGATTGTGAG
TCCGTAACTTCAAGCCGTGTGACT -> CCGTAACTTCAAGCCGTGTGACTT
CGTCGCTCCGGAACGGGTCTACGG -> GTCGCTCCGGAACGGGTCTACGGC
GTCATACCAATAGAAAAATCAGAG -> TCATACCAATAGAAAAATCAGAGC
GCCTCCTCACCCGATAGGACGGCG -> CCTCCTCACCCGATAGGACGGCGA
CATAAACATGTTCTTCGTTATTAC -> ATAAACATGTTCTTCGTTATTACA
GGTCTACGGCCACGATAATCCAGT -> GTCTACGGCCACGATAATCCAGTC
CTTGCTTTATCCTCTTAGTGATTG -> TTGCTTTATCCTCTTAGTGATTGT
GGTGGGACCACTATGAACCATTTC -> GTGGGACCACTATGAACCATTTCA
CCCGGTAGAAGTCTGAATTTAGGG -> CCGGTAGAAGTCTGAATTTAGGGG
CGGTACGTCCAATACGGACGTTTG -> GGTACGTCCAATACGGACGTTTGT
CCGTTTAAGTCGCCAAGATCTATA -> CGTTTAAGTCGCCAAGATCTATAC
CGGCATGTTAGAGCACAGAAGAAT -> GGCATGTTAGAGCACAGAAGAATT
ATTTTCAAGGGTCTTCATAAGTGT -> TTTTCAAGGGTCTTCATAAGTGTC
ACGGAACCGGAACGTAGAAGGTAA -> CGGAACCGGAACGTAGAAGGTAAT
GCATCCCTAAGCTTCCAAGTGACA -> CATCCCTAAGCTTCCAAGTGACAT
TAAATTCGAACACGACCGCTCATG -> AAATTCGAACACGACCGCTCATGG
TGCAACTGAACTTTCGAAAGCGAT -> GCAACTGAACTTTCGAAAGCGATC
TAGAACATTGGAAGACCTCGCAAA -> AGAACATTGGAAGACCTCGCAAAT
GGGTCTTCATAAGTGTCTATACAG -> GGTCTTCATAAGTGTCTATACAGG
CGTAACTTCAAGCCGTGTGACTTC -> GTAACTTCAAGCCGTGTGACTTCG
CCGGTACGTCCAATACGGACGTTT -> CGGTACGTCCAATACGGACGTTTG
ATACGGACGTTTGTTGTAACTGAA -> TACGGACGTTTGTTGTAACTGAAA
CGTCAATATCCTGGACTTACAGAC -> GTCAATATCCTGGACTTACAGACT
GAAAAATCAGAGCATCCCTAAGCT -> AAAAATCAGAGCATCCCTAAGCTT
GTGCAATATGAAGTCGGCAGGGTG -> TGCAATATGAAGTCGGCAGGGTGC
GGCGGGAGCGCCACAGTTGAATTG -> GCGGGAGCGCCACAGTTGAATTGA
AGACCCGTGCTTAGAGCAGTAAAA -> GACCCGTGCTTAGAGCAGTAAAAA
GAAATGAAATTCCTAATCCCAAGC -> AAATGAAATTCCTAATCCCAAGCC
TAGAAGGTAATACCCCAAGGCTGG -> AGAAGGTAATACCCCAAGGCTGGC
TCCGGAACGGGTCTACGGCCACGA -> CCGGAACGGGTCTACGGCCACGAT
CAAAGGCCACTATACGCCCGGTAG -> AAAGGCCACTATACGCCCGGTAGA
CTTAGGGTTTCACTATCTCGTTAC -> TTAGGGTTTCACTATCTCGTTACG
AAGTACGCTTCACCCTATGCACCC -> AGTACGCTTCACCCTATGCACCCG
GGTACGACCGAGCGCATGGCACCT -> GTACGACCGAGCGCATGGCACCTT
GGGATGTACGCTGGCGGCTCCTGA -> GGATGTACGCTGGCGGCTCCTGAC
ACTCCAATCAGGTGCTTTTTTAGC -> CTCCAATCAGGTGCTTTTTTAGCA
ACGTATCTGTAGAACATTGGAAGA -> CGTATCTGTAGAACATTGGAAGAC
AGTGGTGTGCTCGAATAGCATAAA -> GTGGTGTGCTCGAATAGCATAAAT
ACTTAGGCGTAAGAGAGCTTACCC -> CTTAGGCGTAAGAGAGCTTACCCT
CCGGCGACTGATAACACTTGCAAC -> CGGCGACTGATAACACTTGCAACT
ATCCGAAACGACATGACTCCAATC -> TCCGAAACGACATGACTCCAATCA
AAGTCCGCCGGCGACTGATAACAC -> AGTCCGCCGGCGACTGATAACACT
GAACGCCGAAAGTCCGCCGGCGAC -> AACGCCGAAAGTCCGCCGGCGACT
ACCTTGCTTTATCCTCTTAGTGAT -> CCTTGCTTTATCCTCTTAGTGATT
TGACCACCTTAGCATAAGTACGCT -> GACCACCTTAGCATAAGTACGCTT
TGCTGTTAAAGCTGGTCGAGTGAA -> GCTGTTAAAGCTGGTCGAGTGAAG
CCATTGACGCCATACGTCCGTGCT -> CATTGACGCCATACGTCCGTGCTT
TAGGGAATTATCGTCACTAGTGAT -> AGGGAATTATCGTCACTAGTGATG
TAAAAACGCAATTAGGCGGGAGCG -> AAAAACGCAATTAGGCGGGAGCGC
CAGCTCTACGTGGCCGTGTTCACA -> AGCTCTACGTGGCCGTGTTCACAT
GCGAGTCCGGCATGTTAGAGCACA -> CGAGTCCGGCATGTTAGAGCACAG
TGTCTTCACGTCCATGAGAACGCC -> GTCTTCACGTCCATGAGAACGCCT
GTGCTCGAATAGCATAAATTCGAA -> TGCTCGAATAGCATAAATTCGAAC
CAAGTGACATGACCTTGAGGTCGT -> AAGTGACATGACCTTGAGGTCGTC
TTCTTCTGTGGTAACTAGAGTCCA -> TCTTCTGTGGTAACTAGAGTCCAT
AGTGATGTGTCCTGTGTCAGCAAC -> GTGATGTGTCCTGTGTCAGCAACA
CGAGTGAAGGCCTATCCGAAACGA -> GAGTGAAGGCCTATCCGAAACGAC
ATTCTCGAAGCAGCGGTCTGTCAG -> TTCTCGAAGCAGCGGTCTGTCAGT
TCGTTCTCTGCTTTAAATGTTAGC -> CGTTCTCTGCTTTAAATGTTAGCC
AAGCCCATTGGAGATGCCGTCGCT -> AGCCCATTGGAGATGCCGTCGCTC
CATGCTGGGGTCGGGCCTGCTCGC -> ATGCTGGGGTCGGGCCTGCTCGCC
CGCCGAAAGTCCGCCGGCGACTGA -> GCCGAAAGTCCGCCGGCGACTGAT
AGCATAAGTACGCTTCACCCTATG -> GCATAAGTACGCTTCACCCTATGC
TCGCAAATGAATATAGAGATGAGG -> CGCAAATGAATATAGAGATGAGGA
CCAATAGAAAAATCAGAGCATCCC -> CAATAGAAAAATCAGAGCATCCCT
CATACTCCGCTTCTCCCCCCCCTT -> ATACTCCGCTTCTCCCCCCCCTTT
CCGATAGGACGGCGATCAGTACTG -> CGATAGGACGGCGATCAGTACTGA
TCCGGCATGTTAGAGCACAGAAGA -> CCGGCATGTTAGAGCACAGAAGAA
GGAAGACCTCGCAAATGAATATAG -> GAAGACCTCGCAAATGAATATAGA
ATCGCTAAAGACTTATAGTGTCTT -> TCGCTAAAGACTTATAGTGTCTTC
AACCGGGATGTACGCTGGCGGCTC -> ACCGGGATGTACGCTGGCGGCTCC
TACGTCCAATACGGACGTTTGTTG -> ACGTCCAATACGGACGTTTGTTGT
AACTGAACTTTCGAAAGCGATCCA -> ACTGAACTTTCGAAAGCGATCCAA
TCTGTCAGTGGTGTGCTCGAATAG -> CTGTCAGTGGTGTGCTCGAATAGC
ATGAGGATCGGCACGTGGTGGGAC -> TGAGGATCGGCACGTGGTGGGACC
AGATTGTATGCGGCCCCATTCCCA -> GATTGTATGCGGCCCCATTCCCAT
CCGTTCTTCTGTGGTAACTAGAGT -> CGTTCTTCTGTGGTAACTAGAGTC
GATCAGGGTGTAGTCGCCTCCTCA -> ATCAGGGTGTAGTCGCCTCCTCAC
CATTTCTCCGACGCCGATTGTGAG -> ATTTCTCCGACGCCGATTGTGAGG
GTGTAGTCGCCTCCTCACCCGATA -> TGTAGTCGCCTCCTCACCCGATAG
ACTGATAACACTTGCAACTGAACT -> CTGATAACACTTGCAACTGAACTT
GGGCGTCAATATCCTGGACTTACA -> GGCGTCAATATCCTGGACTTACAG
GGATCGGCACGTGGTGGGACCACT -> GATCGGCACGTGGTGGGACCACTA
TACCCCAAGGCTGGCGCGATAGTA -> ACCCCAAGGCTGGCGCGATAGTAG
TACCGTGGCCGGTCATTAAAAGCG -> ACCGTGGCCGGTCATTAAAAGCGC
GGACTTACAGACTGTTTAAGGTTA -> GACTTACAGACTGTTTAAGGTTAC
CCTATGCACCCGTGGTACAACCTC -> CTATGCACCCGTGGTACAACCTCC
CCTTGGTGCCTCTACAGCCGGCCT -> CTTGGTGCCTCTACAGCCGGCCTT
AGTCCATAAACATGTTCTTCGTTA -> GTCCATAAACATGTTCTTCGTTAT
TAGAGTCCATAAACATGTTCTTCG -> AGAGTCCATAAACATGTTCTTCGT
CCAAGATCTATACCCTTGTCTGGG -> CAAGATCTATACCCTTGTCTGGGA
GATTGTATTTCTAGTTCCCTGTGC -> ATTGTATTTCTAGTTCCCTGTGCA
TAAGTGTCTATACAGGATTGCGGT -> AAGTGTCTATACAGGATTGCGGTG
CCAGTCATGCTGGGGTCGGGCCTG -> CAGTCATGCTGGGGTCGGGCCTGC
GCCACAGTTGAATTGATAAACGGT -> CCACAGTTGAATTGATAAACGGTG
ATTTCAAAGGCCACTATACGCCCG -> TTTCAAAGGCCACTATACGCCCGG
TGTGTCAGCAACACTTGGAAGTGC -> GTGTCAGCAACACTTGGAAGTGCG
TGGTCGAGTGAAGGCCTATCCGAA -> GGTCGAGTGAAGGCCTATCCGAAA
ACAAGCCCATTGGAGATGCCGTCG -> CAAGCCCATTGGAGATGCCGTCGC
CGATCAGGGTGTAGTCGCCTCCTC -> GATCAGGGTGTAGTCGCCTCCTCA
TTTAGCACACATGTATTCTGTCAA -> TTAGCACACATGTATTCTGTCAAC
CCGGTCATTAAAAGCGCTGCCCTG -> CGGTCATTAAAAGCGCTGCCCTGT
TCACCCGATAGGACGGCGATCAGT -> CACCCGATAGGACGGCGATCAGTA
ACTAGAGTCCATAAACATGTTCTT -> CTAGAGTCCATAAACATGTTCTTC
GAAGACCTCGCAAATGAATATAGA -> AAGACCTCGCAAATGAATATAGAG
GAGGGCGTCAATATCCTGGACTTA -> AGGGCGTCAATATCCTGGACTTAC
TGCCTGGCTTAGGGTTTCACTATC -> GCCTGGCTTAGGGTTTCACTATCT
CGTAACATTTCTCCGACGCCGATT -> GTAACATTTCTCCGACGCCGATTG
GTGGTACAACCTCCCGGACTGTAG -> TGGTACAACCTCCCGGACTGTAGT
TATGAAGTCGGCAGGGTGCTGTTA -> ATGAAGTCGGCAGGGTGCTGTTAA
AGTCGCCTCCTCACCCGATAGGAC -> GTCGCCTCCTCACCCGATAGGACG
GTCTACGGCCACGATAATCCAGTC -> TCTACGGCCACGATAATCCAGTCA
ATAATCCAGTCATGCTGGGGTCGG -> TAATCCAGTCATGCTGGGGTCGGG
GCGAATGTCGTTTGCGCCCTTGGT -> CGAATGTCGTTTGCGCCCTTGGTG
AGCGCCACAGTTGAATTGATAAAC -> GCGCCACAGTTGAATTGATAAACG
CGGTTTGAACGCCGAAAGTCCGCC -> GGTTTGAACGCCGAAAGTCCGCCG
CAAACCGATATATATTCGCTCAGC -> AAACCGATATATATTCGCTCAGCC
GTGGTAACTAGAGTCCATAAACAT -> TGGTAACTAGAGTCCATAAACATG
TAATCCCAAGCCATACTCCGCTTC -> AATCCCAAGCCATACTCCGCTTCT
CCAAGTGACATGACCTTGAGGTCG -> CAAGTGACATGACCTTGAGGTCGT
TACGGACGTTTGTTGTAACTGAAA -> ACGGACGTTTGTTGTAACTGAAAT
CCCCTTTCGAATTTTCAAGGGTCT -> CCCTTTCGAATTTTCAAGGGTCTT
CATCCTGATGTGTCATACCAATAG -> ATCCTGATGTGTCATACCAATAGA
GTGTGCTTGACCACCTTAGCATAA -> TGTGCTTGACCACCTTAGCATAAG
ACCCCAAGGCTGGCGCGATAGTAG -> CCCCAAGGCTGGCGCGATAGTAGA
TCGTTCAACACAGATAATTCTCTT -> CGTTCAACACAGATAATTCTCTTG
AGGTAATACCCCAAGGCTGGCGCG -> GGTAATACCCCAAGGCTGGCGCGA
CTTGGACACTTGTTACGAGCAGCT -> TTGGACACTTGTTACGAGCAGCTC
AACGTCCCAACTAGAGACCGCCGT -> ACGTCCCAACTAGAGACCGCCGTC
CCCAACTAGAGACCGCCGTCAAAC -> CCAACTAGAGACCGCCGTCAAACC
TGTCAGTGGTGTGCTCGAATAGCA -> GTCAGTGGTGTGCTCGAATAGCAT
CCTTTCGAATTTTCAAGGGTCTTC -> CTTTCGAATTTTCAAGGGTCTTCA
GATAACACTTGCAACTGAACTTTC -> ATAACACTTGCAACTGAACTTTCG
GACCGCCGTCAAACCGATATATAT -> ACCGCCGTCAAACCGATATATATT
CCCCCAATATACTTAGGCGTAAGA -> CCCCAATATACTTAGGCGTAAGAG
GCGGCTCCTGACGCTAACTTACTA -> CGGCTCCTGACGCTAACTTACTAA
CTCATGGTACGACCGAGCGCATGG -> TCATGGTACGACCGAGCGCATGGC
TCTTCATAAGTGTCTATACAGGAT -> CTTCATAAGTGTCTATACAGGATT
CGGAACCGGAACGTAGAAGGTAAT -> GGAACCGGAACGTAGAAGGTAATA
TCGAAAGCGATCCAACCTAGACCC -> CGAAAGCGATCCAACCTAGACCCG
CAATCAGGTGCTTTTTTAGCACAC -> AATCAGGTGCTTTTTTAGCACACA
CCTTGAGGTCGTCTGGTCGACAAA -> CTTGAGGTCGTCTGGTCGACAAAT
TGAGGTCGTCTGGTCGACAAATCT -> GAGGTCGTCTGGTCGACAAATCTC
CTTTAGACTCCCGACAGCCCGTAA -> TTTAGACTCCCGACAGCCCGTAAA
TCGCTAAAGACTTATAGTGTCTTC -> CGCTAAAGACTTATAGTGTCTTCA
AGCGATCCAACCTAGACCCGTGCT -> GCGATCCAACCTAGACCCGTGCTT
TCAGTGAATTTTGTCGATCAGGGT -> CAGTGAATTTTGTCGATCAGGGTG
TTTAAGGTTACTACCGCGACAGCT -> TTAAGGTTACTACCGCGACAGCTT
TCCGACGCCGATTGTGAGGATAAA -> CCGACGCCGATTGTGAGGATAAAC
AGAACGCCTCATCTTTCCGGGCGA -> GAACGCCTCATCTTTCCGGGCGAG
TAACTTACTAAGCCGGTACGTCCA -> AACTTACTAAGCCGGTACGTCCAA
CCGAAAGTCCGCCGGCGACTGATA -> CGAAAGTCCGCCGGCGACTGATAA
TGAAGGCCTATCCGAAACGACATG -> GAAGGCCTATCCGAAACGACATGA
TGGTGCCTCTACAGCCGGCCTTTG -> GGTGCCTCTACAGCCGGCCTTTGG
TCCATGAGAACGCCTCATCTTTCC -> CCATGAGAACGCCTCATCTTTCCG
ATAGTAGATGAGTGCAATATGAAG -> TAGTAGATGAGTGCAATATGAAGT
CTAGTGATGTGTCCTGTGTCAGCA -> TAGTGATGTGTCCTGTGTCAGCAA
GGTTGAATATAATGCCACAACAGA -> GTTGAATATAATGCCACAACAGAA
AGTGTCTATACAGGATTGCGGTGT -> GTGTCTATACAGGATTGCGGTGTG
AACTAGAGACCGCCGTCAAACCGA -> ACTAGAGACCGCCGTCAAACCGAT
CACATGCTGCATCCTGATGTGTCA -> ACATGCTGCATCCTGATGTGTCAT
GACACTTGTTACGAGCAGCTCTAC -> ACACTTGTTACGAGCAGCTCTACG
GTGCGATACCGTGGCCGGTCATTA -> TGCGATACCGTGGCCGGTCATTAA
AAACCGATATATATTCGCTCAGCC -> AACCGATATATATTCGCTCAGCCA
CGTCCCAACTAGAGACCGCCGTCA -> GTCCCAACTAGAGACCGCCGTCAA
AGATCTATACCCTTGTCTGGGACG -> GATCTATACCCTTGTCTGGGACGA
CCACATCGCTAAAGACTTATAGTG -> CACATCGCTAAAGACTTATAGTGT
CTATGAACCATTTCAAAGGCCACT -> TATGAACCATTTCAAAGGCCACTA
GCGGTGTGCTTGACCACCTTAGCA -> CGGTGTGCTTGACCACCTTAGCAT
GTCGAGTGAAGGCCTATCCGAAAC -> TCGAGTGAAGGCCTATCCGAAACG
TATATATTCGCTCAGCCAGAAGAT -> ATATATTCGCTCAGCCAGAAGATT
ACGCCATACGTCCGTGCTTCGCCC -> CGCCATACGTCCGTGCTTCGCCCG
CGCTAACTTACTAAGCCGGTACGT -> GCTAACTTACTAAGCCGGTACGTC
TGGTGTGCTCGAATAGCATAAATT -> GGTGTGCTCGAATAGCATAAATTC
TGTGACTTCGTTCCCCCACATCGC -> GTGACTTCGTTCCCCCACATCGCT
TAGCAGGCCACATGCTGCATCCTG -> AGCAGGCCACATGCTGCATCCTGA
CTTCGTTATTACAATACTCCCTCA -> TTCGTTATTACAATACTCCCTCAA
CGTGGCCGGTCATTAAAAGCGCTG -> GTGGCCGGTCATTAAAAGCGCTGC
CCTTAGCATAAGTACGCTTCACCC -> CTTAGCATAAGTACGCTTCACCCT
ACTTACTAAGCCGGTACGTCCAAT -> CTTACTAAGCCGGTACGTCCAATA
ACATTTCTCCGACGCCGATTGTGA -> CATTTCTCCGACGCCGATTGTGAG
TGTCAGCAACACTTGGAAGTGCGA -> GTCAGCAACACTTGGAAGTGCGAT
ATGTTACTAGACGCGAATGTCGTT -> TGTTACTAGACGCGAATGTCGTTT
AACACAGATAATTCTCTTGGACAC -> ACACAGATAATTCTCTTGGACACT
TGGCGGCTCCTGACGCTAACTTAC -> GGCGGCTCCTGACGCTAACTTACT
TCCCTCAAGTCTAGGGAATTATCG -> CCCTCAAGTCTAGGGAATTATCGT
AAGACTTATAGTGTCTTCACGTCC -> AGACTTATAGTGTCTTCACGTCCA
TTAGGCGTAAGAGAGCTTACCCTA -> TAGGCGTAAGAGAGCTTACCCTAT
CCGAAACGACATGACTCCAATCAG -> CGAAACGACATGACTCCAATCAGG
ACGCGAATGTCGTTTGCGCCCTTG -> CGCGAATGTCGTTTGCGCCCTTGG
GAACCATTTCAAAGGCCACTATAC -> AACCATTTCAAAGGCCACTATACG
TACCCTATCTACATTTACAGCCGG -> ACCCTATCTACATTTACAGCCGGG
CTTAGGCGTAAGAGAGCTTACCCT -> TTAGGCGTAAGAGAGCTTACCCTA
GTGTCAGCAACACTTGGAAGTGCG -> TGTCAGCAACACTTGGAAGTGCGA
TGAGGATAAACCCTACAGCACAAC -> GAGGATAAACCCTACAGCACAACG
CCCAAGGCTGGCGCGATAGTAGAT -> CCAAGGCTGGCGCGATAGTAGATG
GTGAGGGCGTCAATATCCTGGACT -> TGAGGGCGTCAATATCCTGGACTT
AGTGATTGTATTTCTAGTTCCCTG -> GTGATTGTATTTCTAGTTCCCTGT
GCCTGGCTTAGGGTTTCACTATCT -> CCTGGCTTAGGGTTTCACTATCTC
GCCTTTGGAAACTGCTCGTTCTCT -> CCTTTGGAAACTGCTCGTTCTCTG
CCCAAGCCATACTCCGCTTCTCCC -> CCAAGCCATACTCCGCTTCTCCCC
TTGAATTGATAAACGGTGAAGCTT -> TGAATTGATAAACGGTGAAGCTTA
TACAGCCATTGACGCCATACGTCC -> ACAGCCATTGACGCCATACGTCCG
TGAGGGCGTCAATATCCTGGACTT -> GAGGGCGTCAATATCCTGGACTTA
TTTAAATGTTAGCCGGTTTGAACG -> TTAAATGTTAGCCGGTTTGAACGC
AATCAGAGCATCCCTAAGCTTCCA -> ATCAGAGCATCCCTAAGCTTCCAA
CCTTGCTTTATCCTCTTAGTGATT -> CTTGCTTTATCCTCTTAGTGATTG
TTCCCCCACATCGCTAAAGACTTA -> TCCCCCACATCGCTAAAGACTTAT
GCTTAGAGCAGTAAAAACGCAATT -> CTTAGAGCAGTAAAAACGCAATTA
TCTTCGTTATTACAATACTCCCTC -> CTTCGTTATTACAATACTCCCTCA
TCCCTAAGCTTCCAAGTGACATGA -> CCCTAAGCTTCCAAGTGACATGAC
ATTCGCTCAGCCAGAAGATTGTAT -> TTCGCTCAGCCAGAAGATTGTATG
ATCTATACCCTTGTCTGGGACGAA -> TCTATACCCTTGTCTGGGACGAAG
CGCCAATTCCGTTTAAGTCGCCAA -> GCCAATTCCGTTTAAGTCGCCAAG
AGAAGGTAATACCCCAAGGCTGGC -> GAAGGTAATACCCCAAGGCTGGCG
GTTTGCGCCCTTGGTGCCTCTACA -> TTTGCGCCCTTGGTGCCTCTACAG
GAGATCCGGATTGTGAGGGCGTCA -> AGATCCGGATTGTGAGGGCGTCAA
TTCTTCGTTATTACAATACTCCCT -> TCTTCGTTATTACAATACTCCCTC
TAGCATAAGTACGCTTCACCCTAT -> AGCATAAGTACGCTTCACCCTATG
CGCCGGCGACTGATAACACTTGCA -> GCCGGCGACTGATAACACTTGCAA
TTGAACGCCGAAAGTCCGCCGGCG -> TGAACGCCGAAAGTCCGCCGGCGA
CAGGCCACATGCTGCATCCTGATG -> AGGCCACATGCTGCATCCTGATGT
CTTCACGTATCTGTAGAACATTGG -> TTCACGTATCTGTAGAACATTGGA
TATCGTCACTAGTGATGTGTCCTG -> ATCGTCACTAGTGATGTGTCCTGT
CACGTGGTGGGACCACTATGAACC -> ACGTGGTGGGACCACTATGAACCA
TACGTCCGTGCTTCGCCCGTTCTT -> ACGTCCGTGCTTCGCCCGTTCTTC
TGAAGTCGGCAGGGTGCTGTTAAA -> GAAGTCGGCAGGGTGCTGTTAAAG
GGAACGTAGAAGGTAATACCCCAA -> GAACGTAGAAGGTAATACCCCAAG
TCATCTTTCCGGGCGAGTCCGGCA -> CATCTTTCCGGGCGAGTCCGGCAT
CTTACCCTATCTACATTTACAGCC -> TTACCCTATCTACATTTACAGCCG
AAGAGATCCGGATTGTGAGGGCGT -> AGAGATCCGGATTGTGAGGGCGTC
ATGAGTGCAATATGAAGTCGGCAG -> TGAGTGCAATATGAAGTCGGCAGG
GTTACGAGCAGCTCTACGTGGCCG -> TTACGAGCAGCTCTACGTGGCCGT
CGAATGTCGTTTGCGCCCTTGGTG -> GAATGTCGTTTGCGCCCTTGGTGC
GGTACGTCCAATACGGACGTTTGT -> GTACGTCCAATACGGACGTTTGTT
GTATCTGTAGAACATTGGAAGACC -> TATCTGTAGAACATTGGAAGACCT
GTAACTGAAATGAAATTCCTAATC -> TAACTGAAATGAAATTCCTAATCC
GGGTCTACGGCCACGATAATCCAG -> GGTCTACGGCCACGATAATCCAGT
AACGCCTCATCTTTCCGGGCGAGT -> ACGCCTCATCTTTCCGGGCGAGTC
CTGTAGAACATTGGAAGACCTCGC -> TGTAGAACATTGGAAGACCTCGCA
CTACGGCCACGATAATCCAGTCAT -> TACGGCCACGATAATCCAGTCATG
CGCCAAGATCTATACCCTTGTCTG -> GCCAAGATCTATACCCTTGTCTGG
AACGCCGAAAGTCCGCCGGCGACT -> ACGCCGAAAGTCCGCCGGCGACTG
ACTAGACGCGAATGTCGTTTGCGC -> CTAGACGCGAATGTCGTTTGCGCC
CTCCGTAACTTCAAGCCGTGTGAC -> TCCGTAACTTCAAGCCGTGTGACT
ACCGCCGTCAAACCGATATATATT -> CCGCCGTCAAACCGATATATATTC
ATGTTAGAGCACAGAAGAATTCTC -> TGTTAGAGCACAGAAGAATTCTCG
GTACGTCCAATACGGACGTTTGTT -> TACGTCCAATACGGACGTTTGTTG
CACAGATAATTCTCTTGGACACTT -> ACAGATAATTCTCTTGGACACTTG
ACAACGTCCCAACTAGAGACCGCC -> CAACGTCCCAACTAGAGACCGCCG
TTACAGCCATTGACGCCATACGTC -> TACAGCCATTGACGCCATACGTCC
CGCGAATGTCGTTTGCGCCCTTGG -> GCGAATGTCGTTTGCGCCCTTGGT
AAGCTTAGCAGGCCACATGCTGCA -> AGCTTAGCAGGCCACATGCTGCAT
GTAACTAGAGTCCATAAACATGTT -> TAACTAGAGTCCATAAACATGTTC
GTGTCATACCAATAGAAAAATCAG -> TGTCATACCAATAGAAAAATCAGA
CGAATAGCATAAATTCGAACACGA -> GAATAGCATAAATTCGAACACGAC
TAGTTCCCTGTGCATCAGTGAATT -> AGTTCCCTGTGCATCAGTGAATTT
AATCAGGTGCTTTTTTAGCACACA -> ATCAGGTGCTTTTTTAGCACACAT
AGCTTACAGCCATTGACGCCATAC -> GCTTACAGCCATTGACGCCATACG
CGCGACAGCTTTTCGTAACATTTC -> GCGACAGCTTTTCGTAACATTTCT
ATATGAAGTCGGCAGGGTGCTGTT -> TATGAAGTCGGCAGGGTGCTGTTA
AAGATCTATACCCTTGTCTGGGAC -> AGATCTATACCCTTGTCTGGGACG
CTTCACGTCCATGAGAACGCCTCA -> TTCACGTCCATGAGAACGCCTCAT
TGTACGCTGGCGGCTCCTGACGCT -> GTACGCTGGCGGCTCCTGACGCTA
ATGGTACGACCGAGCGCATGGCAC -> TGGTACGACCGAGCGCATGGCACC
AAGCGATCCAACCTAGACCCGTGC -> AGCGATCCAACCTAGACCCGTGCT
ACTGAAATGAAATTCCTAATCCCA -> CTGAAATGAAATTCCTAATCCCAA
CCCGTTCTTCTGTGGTAACTAGAG -> CCGTTCTTCTGTGGTAACTAGAGT
GCCTTATTCCCTCGTTCAACACAG -> CCTTATTCCCTCGTTCAACACAGA
GGCTCCTGACGCTAACTTACTAAG -> GCTCCTGACGCTAACTTACTAAGC
ATTGATAAACGGTGAAGCTTACAG -> TTGATAAACGGTGAAGCTTACAGC
CGGGTCTACGGCCACGATAATCCA -> GGGTCTACGGCCACGATAATCCAG
GGCGAGTCCGGCATGTTAGAGCAC -> GCGAGTCCGGCATGTTAGAGCACA
CTAGTTCCCTGTGCATCAGTGAAT -> TAGTTCCCTGTGCATCAGTGAATT
CCGTAACTTCAAGCCGTGTGACTT -> CGTAACTTCAAGCCGTGTGACTTC
GTGTCTTCACGTCCATGAGAACGC -> TGTCTTCACGTCCATGAGAACGCC
TTCATAAGTGTCTATACAGGATTG -> TCATAAGTGTCTATACAGGATTGC
TGTGCTCGAATAGCATAAATTCGA -> GTGCTCGAATAGCATAAATTCGAA
TCTGTCAACCGGGATGTACGCTGG -> CTGTCAACCGGGATGTACGCTGGC
CGCTTCTCCCCCCCCTTTCGAATT -> GCTTCTCCCCCCCCTTTCGAATTT
AAAAATCAGAGCATCCCTAAGCTT -> AAAATCAGAGCATCCCTAAGCTTC
CCCCCACATCGCTAAAGACTTATA -> CCCCACATCGCTAAAGACTTATAG
TAGGGGGTTACAAACTTGAACCTC -> AGGGGGTTACAAACTTGAACCTCT
TCTGAATTTAGGGGGTTACAAACT -> CTGAATTTAGGGGGTTACAAACTT
ACAGAAGAATTCTCGAAGCAGCGG -> CAGAAGAATTCTCGAAGCAGCGGT
GGTCGAGTGAAGGCCTATCCGAAA -> GTCGAGTGAAGGCCTATCCGAAAC
TTGGACACTTGTTACGAGCAGCTC -> TGGACACTTGTTACGAGCAGCTCT
GAGATGAGGATCGGCACGTGGTGG -> AGATGAGGATCGGCACGTGGTGGG
AGGGTGCTGTTAAAGCTGGTCGAG -> GGGTGCTGTTAAAGCTGGTCGAGT
AGCACAGAAGAATTCTCGAAGCAG -> GCACAGAAGAATTCTCGAAGCAGC
AGGCCACTATACGCCCGGTAGAAG -> GGCCACTATACGCCCGGTAGAAGT
CTCCCGACAGCCCGTAAAAGCATC -> TCCCGACAGCCCGTAAAAGCATCT
GGATGTACGCTGGCGGCTCCTGAC -> GATGTACGCTGGCGGCTCCTGACG
ATAAACCCTACAGCACAACGTCCC -> TAAACCCTACAGCACAACGTCCCA
GGTGCTTTTTTAGCACACATGTAT -> GTGCTTTTTTAGCACACATGTATT
GTCAACCGGGATGTACGCTGGCGG -> TCAACCGGGATGTACGCTGGCGGC
CCCCCCTTTCGAATTTTCAAGGGT -> CCCCCTTTCGAATTTTCAAGGGTC
AGCAGTAAAAACGCAATTAGGCGG -> GCAGTAAAAACGCAATTAGGCGGG
GCCGGCGACTGATAACACTTGCAA -> CCGGCGACTGATAACACTTGCAAC
TGTATGCGGCCCCATTCCCATCAA -> GTATGCGGCCCCATTCCCATCAAC
CCCACATCGCTAAAGACTTATAGT -> CCACATCGCTAAAGACTTATAGTG
GACGCTAACTTACTAAGCCGGTAC -> ACGCTAACTTACTAAGCCGGTACG
GTATTCTGTCAACCGGGATGTACG -> TATTCTGTCAACCGGGATGTACGC
CCGTCGCTCCGGAACGGGTCTACG -> CGTCGCTCCGGAACGGGTCTACGG
TGGTACAACCTCCCGGACTGTAGT -> GGTACAACCTCCCGGACTGTAGTA
AATTCTCTTGGACACTTGTTACGA -> ATTCTCTTGGACACTTGTTACGAG
CGTAGAAGGTAATACCCCAAGGCT -> GTAGAAGGTAATACCCCAAGGCTG
TATAGAGATGAGGATCGGCACGTG -> ATAGAGATGAGGATCGGCACGTGG
AACGGTTCAAGAGCTAACCCCCCA -> ACGGTTCAAGAGCTAACCCCCCAA
TAGGGTTTCACTATCTCGTTACGG -> AGGGTTTCACTATCTCGTTACGGA
TATAGTGTCTTCACGTCCATGAGA -> ATAGTGTCTTCACGTCCATGAGAA
GGTTTCACTATCTCGTTACGGAAC -> GTTTCACTATCTCGTTACGGAACC
TTCCAAGTGACATGACCTTGAGGT -> TCCAAGTGACATGACCTTGAGGTC
AGCTTAGCAGGCCACATGCTGCAT -> GCTTAGCAGGCCACATGCTGCATC
GCCCGGTAGAAGTCTGAATTTAGG -> CCCGGTAGAAGTCTGAATTTAGGG
CCAATACGGACGTTTGTTGTAACT -> CAATACGGACGTTTGTTGTAACTG
TATACCCTTGTCTGGGACGAAGTC -> ATACCCTTGTCTGGGACGAAGTCG
TTCGTTCCCCCACATCGCTAAAGA -> TCGTTCCCCCACATCGCTAAAGAC
GTTAAAGCTGGTCGAGTGAAGGCC -> TTAAAGCTGGTCGAGTGAAGGCCT
GTGGTGTGCTCGAATAGCATAAAT -> TGGTGTGCTCGAATAGCATAAATT
AGACTGTTTAAGGTTACTACCGCG -> GACTGTTTAAGGTTACTACCGCGA
CGGGCCTGCTCGCCAACTCGCCAA -> GGGCCTGCTCGCCAACTCGCCAAT
AATGTTAGCCGGTTTGAACGCCGA -> ATGTTAGCCGGTTTGAACGCCGAA
CTCGTTCTCTGCTTTAAATGTTAG -> TCGTTCTCTGCTTTAAATGTTAGC
GATCCGGATTGTGAGGGCGTCAAT -> ATCCGGATTGTGAGGGCGTCAATA
CTGCCCTGTAAAGTAAGAGATCCG -> TGCCCTGTAAAGTAAGAGATCCGG
GTACGCTTCACCCTATGCACCCGT -> TACGCTTCACCCTATGCACCCGTG
TACAGACTGTTTAAGGTTACTACC -> ACAGACTGTTTAAGGTTACTACCG
TCTTTCCGGGCGAGTCCGGCATGT -> CTTTCCGGGCGAGTCCGGCATGTT
CCTGTAAAGTAAGAGATCCGGATT -> CTGTAAAGTAAGAGATCCGGATTG
TGAGAACGCCTCATCTTTCCGGGC -> GAGAACGCCTCATCTTTCCGGGCG
CTTCACCCTATGCACCCGTGGTAC -> TTCACCCTATGCACCCGTGGTACA
TAGACCCGTGCTTAGAGCAGTAAA -> AGACCCGTGCTTAGAGCAGTAAAA
ACTATGAACCATTTCAAAGGCCAC -> CTATGAACCATTTCAAAGGCCACT
CTACAGCCGGCCTTTGGAAACTGC -> TACAGCCGGCCTTTGGAAACTGCT
GTAGATGAGTGCAATATGAAGTCG -> TAGATGAGTGCAATATGAAGTCGG
AGATAATTCTCTTGGACACTTGTT -> GATAATTCTCTTGGACACTTGTTA
GACGCGAATGTCGTTTGCGCCCTT -> ACGCGAATGTCGTTTGCGCCCTTG
ATACCAATAGAAAAATCAGAGCAT -> TACCAATAGAAAAATCAGAGCATC
CAGGTGCTTTTTTAGCACACATGT -> AGGTGCTTTTTTAGCACACATGTA
GTTCACATGGATGTTACTAGACGC -> TTCACATGGATGTTACTAGACGCG
GTCGACAAATCTCCGTAACTTCAA -> TCGACAAATCTCCGTAACTTCAAG
ATGTACGCTGGCGGCTCCTGACGC -> TGTACGCTGGCGGCTCCTGACGCT
TTCTCGAAGCAGCGGTCTGTCAGT -> TCTCGAAGCAGCGGTCTGTCAGTG
CATGAGAACGCCTCATCTTTCCGG -> ATGAGAACGCCTCATCTTTCCGGG
CCGTGTGACTTCGTTCCCCCACAT -> CGTGTGACTTCGTTCCCCCACATC
CAGAAGATTGTATGCGGCCCCATT -> AGAAGATTGTATGCGGCCCCATTC
TGTTTAAGGTTACTACCGCGACAG -> GTTTAAGGTTACTACCGCGACAGC
TTACAAACTTGAACCTCTTAACGG -> TACAAACTTGAACCTCTTAACGGT
TGCCGTCGCTCCGGAACGGGTCTA -> GCCGTCGCTCCGGAACGGGTCTAC
GTACGACCGAGCGCATGGCACCTT -> TACGACCGAGCGCATGGCACCTTT
TCCTGACGCTAACTTACTAAGCCG -> CCTGACGCTAACTTACTAAGCCGG
AACTTTCGAAAGCGATCCAACCTA -> ACTTTCGAAAGCGATCCAACCTAG
CGTATCTGTAGAACATTGGAAGAC -> GTATCTGTAGAACATTGGAAGACC
TCAGAGCATCCCTAAGCTTCCAAG -> CAGAGCATCCCTAAGCTTCCAAGT
ACGGGTCTACGGCCACGATAATCC -> CGGGTCTACGGCCACGATAATCCA
CCGGTAGAAGTCTGAATTTAGGGG -> CGGTAGAAGTCTGAATTTAGGGGG
TGTAGTCGCCTCCTCACCCGATAG -> GTAGTCGCCTCCTCACCCGATAGG
AACTTACTAAGCCGGTACGTCCAA -> ACTTACTAAGCCGGTACGTCCAAT
TTCTGTGGTAACTAGAGTCCATAA -> TCTGTGGTAACTAGAGTCCATAAA
CACTAGTGATGTGTCCTGTGTCAG -> ACTAGTGATGTGTCCTGTGTCAGC
AATTGATAAACGGTGAAGCTTACA -> ATTGATAAACGGTGAAGCTTACAG
GAGTGAAGGCCTATCCGAAACGAC -> AGTGAAGGCCTATCCGAAACGACA
CCGGGTTGAATATAATGCCACAAC -> CGGGTTGAATATAATGCCACAACA
CTGCTGCAAGCTTAGCAGGCCACA -> TGCTGCAAGCTTAGCAGGCCACAT
TGCTTGACCACCTTAGCATAAGTA -> GCTTGACCACCTTAGCATAAGTAC
CTCTGCTTTAAATGTTAGCCGGTT -> TCTGCTTTAAATGTTAGCCGGTTT
GATAGTAGATGAGTGCAATATGAA -> ATAGTAGATGAGTGCAATATGAAG
GATAATTCTCTTGGACACTTGTTA -> ATAATTCTCTTGGACACTTGTTAC
TTCTCCGACGCCGATTGTGAGGAT -> TCTCCGACGCCGATTGTGAGGATA
GGCCTTATTCCCTCGTTCAACACA -> GCCTTATTCCCTCGTTCAACACAG
GACCGAGCGCATGGCACCTTTAGA -> ACCGAGCGCATGGCACCTTTAGAC
TCTGGTCGACAAATCTCCGTAACT -> CTGGTCGACAAATCTCCGTAACTT
GACTTATAGTGTCTTCACGTCCAT -> ACTTATAGTGTCTTCACGTCCATG
TTCAAGAGCTAACCCCCCAATATA -> TCAAGAGCTAACCCCCCAATATAC
CGGTCTGTCAGTGGTGTGCTCGAA -> GGTCTGTCAGTGGTGTGCTCGAAT
TCAAACCGATATATATTCGCTCAG -> CAAACCGATATATATTCGCTCAGC
ACAGTTGAATTGATAAACGGTGAA -> CAGTTGAATTGATAAACGGTGAAG
CGAGCAGCTCTACGTGGCCGTGTT -> GAGCAGCTCTACGTGGCCGTGTTC
CGAGTCCGGCATGTTAGAGCACAG -> GAGTCCGGCATGTTAGAGCACAGA
TGCTCGCCAACTCGCCAATTCCGT -> GCTCGCCAACTCGCCAATTCCGTT
TCGGCACGTGGTGGGACCACTATG -> CGGCACGTGGTGGGACCACTATGA
GTCTAGGGAATTATCGTCACTAGT -> TCTAGGGAATTATCGTCACTAGTG
CAAATCTCCGTAACTTCAAGCCGT -> AAATCTCCGTAACTTCAAGCCGTG
ACAACAGAAGTCGGCATGCCTGGC -> CAACAGAAGTCGGCATGCCTGGCT
TTAGCATAAGTACGCTTCACCCTA -> TAGCATAAGTACGCTTCACCCTAT
CATACGTCCGTGCTTCGCCCGTTC -> ATACGTCCGTGCTTCGCCCGTTCT
CAGGGTGCTGTTAAAGCTGGTCGA -> AGGGTGCTGTTAAAGCTGGTCGAG
CATCGCTAAAGACTTATAGTGTCT -> ATCGCTAAAGACTTATAGTGTCTT
TCGTAACATTTCTCCGACGCCGAT -> CGTAACATTTCTCCGACGCCGATT
CCTCCTCACCCGATAGGACGGCGA -> CTCCTCACCCGATAGGACGGCGAT
CGCAATTAGGCGGGAGCGCCACAG -> GCAATTAGGCGGGAGCGCCACAGT
CGTTATTACAATACTCCCTCAAGT -> GTTATTACAATACTCCCTCAAGTC
TATTCCCTCGTTCAACACAGATAA -> ATTCCCTCGTTCAACACAGATAAT
CTGATGTGTCATACCAATAGAAAA -> TGATGTGTCATACCAATAGAAAAA
TCTCTGCTTTAAATGTTAGCCGGT -> CTCTGCTTTAAATGTTAGCCGGTT
TAAGGTTACTACCGCGACAGCTTT -> AAGGTTACTACCGCGACAGCTTTT
GATAAACCCTACAGCACAACGTCC -> ATAAACCCTACAGCACAACGTCCC
GACGAAGTCGGCCTTATTCCCTCG -> ACGAAGTCGGCCTTATTCCCTCGT
TGTATTTCTAGTTCCCTGTGCATC -> GTATTTCTAGTTCCCTGTGCATCA
TCCCGGACTGTAGTAACTCCTGGT -> CCCGGACTGTAGTAACTCCTGGTC
CCGATATATATTCGCTCAGCCAGA -> CGATATATATTCGCTCAGCCAGAA
TACTACCGCGACAGCTTTTCGTAA -> ACTACCGCGACAGCTTTTCGTAAC
TAGTCGCCTCCTCACCCGATAGGA -> AGTCGCCTCCTCACCCGATAGGAC
AGTGACATGACCTTGAGGTCGTCT -> GTGACATGACCTTGAGGTCGTCTG
AGTTCCCTGTGCATCAGTGAATTT -> GTTCCCTGTGCATCAGTGAATTTT
ACCGGGATGTACGCTGGCGGCTCC -> CCGGGATGTACGCTGGCGGCTCCT
AAAATCAGAGCATCCCTAAGCTTC -> AAATCAGAGCATCCCTAAGCTTCC
CGCAAATGAATATAGAGATGAGGA -> GCAAATGAATATAGAGATGAGGAT
CTCCCGGACTGTAGTAACTCCTGG -> TCCCGGACTGTAGTAACTCCTGGT
AGCATCCCTAAGCTTCCAAGTGAC -> GCATCCCTAAGCTTCCAAGTGACA
CATCCCTAAGCTTCCAAGTGACAT -> ATCCCTAAGCTTCCAAGTGACATG
GGGTTTCACTATCTCGTTACGGAA -> GGTTTCACTATCTCGTTACGGAAC
GTCTGAATTTAGGGGGTTACAAAC -> TCTGAATTTAGGGGGTTACAAACT
GCGGGAGCGCCACAGTTGAATTGA -> CGGGAGCGCCACAGTTGAATTGAT
GCTGTTAAAGCTGGTCGAGTGAAG -> CTGTTAAAGCTGGTCGAGTGAAGG
GACTGTTTAAGGTTACTACCGCGA -> ACTGTTTAAGGTTACTACCGCGAC
TGAAATTCCTAATCCCAAGCCATA -> GAAATTCCTAATCCCAAGCCATAC
CGAGCGCATGGCACCTTTAGACTC -> GAGCGCATGGCACCTTTAGACTCC
GCAGTAAAAACGCAATTAGGCGGG -> CAGTAAAAACGCAATTAGGCGGGA
ATTGCGGTGTGCTTGACCACCTTA -> TTGCGGTGTGCTTGACCACCTTAG
GTGGCCGTGTTCACATGGATGTTA -> TGGCCGTGTTCACATGGATGTTAC
ACCCGTGCTTAGAGCAGTAAAAAC -> CCCGTGCTTAGAGCAGTAAAAACG
ATGCCTGGCTTAGGGTTTCACTAT -> TGCCTGGCTTAGGGTTTCACTATC
GCTAACCCCCCAATATACTTAGGC -> CTAACCCCCCAATATACTTAGGCG
ACTAAGCCGGTACGTCCAATACGG -> CTAAGCCGGTACGTCCAATACGGA
AATTCGAACACGACCGCTCATGGT -> ATTCGAACACGACCGCTCATGGTA
AGATGCCGTCGCTCCGGAACGGGT -> GATGCCGTCGCTCCGGAACGGGTC
TCGCTCAGCCAGAAGATTGTATGC -> CGCTCAGCCAGAAGATTGTATGCG
TACCAATAGAAAAATCAGAGCATC -> ACCAATAGAAAAATCAGAGCATCC
TACTCCGCTTCTCCCCCCCCTTTC -> ACTCCGCTTCTCCCCCCCCTTTCG
CCCTTTCGAATTTTCAAGGGTCTT -> CCTTTCGAATTTTCAAGGGTCTTC
GTTACTAGACGCGAATGTCGTTTG -> TTACTAGACGCGAATGTCGTTTGC
CCCGTGCTTAGAGCAGTAAAAACG -> CCGTGCTTAGAGCAGTAAAAACGC
AAGAATTCTCGAAGCAGCGGTCTG -> AGAATTCTCGAAGCAGCGGTCTGT
GCTTACCCTATCTACATTTACAGC -> CTTACCCTATCTACATTTACAGCC
CGTAAAAGCATCTTCACGTATCTG -> GTAAAAGCATCTTCACGTATCTGT
AGCTTTTCGTAACATTTCTCCGAC -> GCTTTTCGTAACATTTCTCCGACG
GTCCGGCATGTTAGAGCACAGAAG -> TCCGGCATGTTAGAGCACAGAAGA
GATGTTACTAGACGCGAATGTCGT -> ATGTTACTAGACGCGAATGTCGTT
GCCGTCGCTCCGGAACGGGTCTAC -> CCGTCGCTCCGGAACGGGTCTACG
TCAAAGGCCACTATACGCCCGGTA -> CAAAGGCCACTATACGCCCGGTAG
TTAAGTCGCCAAGATCTATACCCT -> TAAGTCGCCAAGATCTATACCCTT
GAGCATCCCTAAGCTTCCAAGTGA -> AGCATCCCTAAGCTTCCAAGTGAC
TACTTAGGCGTAAGAGAGCTTACC -> ACTTAGGCGTAAGAGAGCTTACCC
AAAGGCCACTATACGCCCGGTAGA -> AAGGCCACTATACGCCCGGTAGAA
ATTCCCATCAACCTTGCTTTATCC -> TTCCCATCAACCTTGCTTTATCCT
ACTCCCGACAGCCCGTAAAAGCAT -> CTCCCGACAGCCCGTAAAAGCATC
ACGCAATTAGGCGGGAGCGCCACA -> CGCAATTAGGCGGGAGCGCCACAG
ACTTACAGACTGTTTAAGGTTACT -> CTTACAGACTGTTTAAGGTTACTA
GGCTGGCGCGATAGTAGATGAGTG -> GCTGGCGCGATAGTAGATGAGTGC
GTTCCCTGTGCATCAGTGAATTTT -> TTCCCTGTGCATCAGTGAATTTTG
TTGCTTTATCCTCTTAGTGATTGT -> TGCTTTATCCTCTTAGTGATTGTA
GTGTGCTCGAATAGCATAAATTCG -> TGTGCTCGAATAGCATAAATTCGA
AAATGAAATTCCTAATCCCAAGCC -> AATGAAATTCCTAATCCCAAGCCA
GTTCAACACAGATAATTCTCTTGG -> TTCAACACAGATAATTCTCTTGGA
GCTCAGCCAGAAGATTGTATGCGG -> CTCAGCCAGAAGATTGTATGCGGC
GATGTGTCCTGTGTCAGCAACACT -> ATGTGTCCTGTGTCAGCAACACTT
ACACATGTATTCTGTCAACCGGGA -> CACATGTATTCTGTCAACCGGGAT
TCTTCTGTGGTAACTAGAGTCCAT -> CTTCTGTGGTAACTAGAGTCCATA
ATTCTGTCAACCGGGATGTACGCT -> TTCTGTCAACCGGGATGTACGCTG
TGCTTAGAGCAGTAAAAACGCAAT -> GCTTAGAGCAGTAAAAACGCAATT
TCTATACAGGATTGCGGTGTGCTT -> CTATACAGGATTGCGGTGTGCTTG
CATTCCCATCAACCTTGCTTTATC -> ATTCCCATCAACCTTGCTTTATCC
TCAACACAGATAATTCTCTTGGAC -> CAACACAGATAATTCTCTTGGACA
TTTCTCCGACGCCGATTGTGAGGA -> TTCTCCGACGCCGATTGTGAGGAT
TTTAGGGGGTTACAAACTTGAACC -> TTAGGGGGTTACAAACTTGAACCT
TGGGGTCGGGCCTGCTCGCCAACT -> GGGGTCGGGCCTGCTCGCCAACTC
AAGATTGTATGCGGCCCCATTCCC -> AGATTGTATGCGGCCCCATTCCCA
GGAACGGGTCTACGGCCACGATAA -> GAACGGGTCTACGGCCACGATAAT
ACAATACTCCCTCAAGTCTAGGGA -> CAATACTCCCTCAAGTCTAGGGAA
TTCCCTCGTTCAACACAGATAATT -> TCCCTCGTTCAACACAGATAATTC
CTTATTCCCTCGTTCAACACAGAT -> TTATTCCCTCGTTCAACACAGATA
AACTTGAACCTCTTAACGGTTCAA -> ACTTGAACCTCTTAACGGTTCAAG
AGAAGAATTCTCGAAGCAGCGGTC -> GAAGAATTCTCGAAGCAGCGGTCT
TGGCACCTTTAGACTCCCGACAGC -> GGCACCTTTAGACTCCCGACAGCC
CTTGTTACGAGCAGCTCTACGTGG -> TTGTTACGAGCAGCTCTACGTGGC
AAAAGCGCTGCCCTGTAAAGTAAG -> AAAGCGCTGCCCTGTAAAGTAAGA
GTCGCCAAGATCTATACCCTTGTC -> TCGCCAAGATCTATACCCTTGTCT
GAAGTCGGCATGCCTGGCTTAGGG -> AAGTCGGCATGCCTGGCTTAGGGT
TCGCCAATTCCGTTTAAGTCGCCA -> CGCCAATTCCGTTTAAGTCGCCAA
CATGTATTCTGTCAACCGGGATGT -> ATGTATTCTGTCAACCGGGATGTA
CTCGCCAACTCGCCAATTCCGTTT -> TCGCCAACTCGCCAATTCCGTTTA
AATTCTCGAAGCAGCGGTCTGTCA -> ATTCTCGAAGCAGCGGTCTGTCAG
CATTAAAAGCGCTGCCCTGTAAAG -> ATTAAAAGCGCTGCCCTGTAAAGT
AGAACATTGGAAGACCTCGCAAAT -> GAACATTGGAAGACCTCGCAAATG
TTCCCTGTGCATCAGTGAATTTTG -> TCCCTGTGCATCAGTGAATTTTGT
TGGCCGGTCATTAAAAGCGCTGCC -> GGCCGGTCATTAAAAGCGCTGCCC
GACCGCTCATGGTACGACCGAGCG -> ACCGCTCATGGTACGACCGAGCGC
TCTATACCCTTGTCTGGGACGAAG -> CTATACCCTTGTCTGGGACGAAGT
ATAAACATGTTCTTCGTTATTACA -> TAAACATGTTCTTCGTTATTACAA
CTCGTTCAACACAGATAATTCTCT -> TCGTTCAACACAGATAATTCTCTT
GAAGATTGTATGCGGCCCCATTCC -> AAGATTGTATGCGGCCCCATTCCC
ACCCTTGTCTGGGACGAAGTCGGC -> CCCTTGTCTGGGACGAAGTCGGCC
AGTAAAAACGCAATTAGGCGGGAG -> GTAAAAACGCAATTAGGCGGGAGC
ACATGGATGTTACTAGACGCGAAT -> CATGGATGTTACTAGACGCGAATG
CATAAGTACGCTTCACCCTATGCA -> ATAAGTACGCTTCACCCTATGCAC
GCTCCGTACAAGCCCATTGGAGAT -> CTCCGTACAAGCCCATTGGAGATG
CCCCAAGGCTGGCGCGATAGTAGA -> CCCAAGGCTGGCGCGATAGTAGAT
ATGAAGTCGGCAGGGTGCTGTTAA -> TGAAGTCGGCAGGGTGCTGTTAAA
AAGCGCTGCCCTGTAAAGTAAGAG -> AGCGCTGCCCTGTAAAGTAAGAGA
CTTACAGACTGTTTAAGGTTACTA -> TTACAGACTGTTTAAGGTTACTAC
GAGCTAACCCCCCAATATACTTAG -> AGCTAACCCCCCAATATACTTAGG
ATCCTGGACTTACAGACTGTTTAA -> TCCTGGACTTACAGACTGTTTAAG
TGGGACCACTATGAACCATTTCAA -> GGGACCACTATGAACCATTTCAAA
ATCTCGTTACGGAACCGGAACGTA -> TCTCGTTACGGAACCGGAACGTAG
GAAGTGCGATACCGTGGCCGGTCA -> AAGTGCGATACCGTGGCCGGTCAT
GTGCATCAGTGAATTTTGTCGATC -> TGCATCAGTGAATTTTGTCGATCA
AAGTGCGATACCGTGGCCGGTCAT -> AGTGCGATACCGTGGCCGGTCATT
CCTCACCCGATAGGACGGCGATCA -> CTCACCCGATAGGACGGCGATCAG
TCGTTATTACAATACTCCCTCAAG -> CGTTATTACAATACTCCCTCAAGT
ATTGGAGATGCCGTCGCTCCGGAA -> TTGGAGATGCCGTCGCTCCGGAAC
CACATGTATTCTGTCAACCGGGAT -> ACATGTATTCTGTCAACCGGGATG
CTTGACCACCTTAGCATAAGTACG -> TTGACCACCTTAGCATAAGTACGC
TGATGTGTCATACCAATAGAAAAA -> GATGTGTCATACCAATAGAAAAAT
TACAGGATTGCGGTGTGCTTGACC -> ACAGGATTGCGGTGTGCTTGACCA
GCCGGTCATTAAAAGCGCTGCCCT -> CCGGTCATTAAAAGCGCTGCCCTG
ACGAAGTCGGCCTTATTCCCTCGT -> CGAAGTCGGCCTTATTCCCTCGTT
CGATAGTAGATGAGTGCAATATGA -> GATAGTAGATGAGTGCAATATGAA
TCAACCTTGCTTTATCCTCTTAGT -> CAACCTTGCTTTATCCTCTTAGTG
TCCAATACGGACGTTTGTTGTAAC -> CCAATACGGACGTTTGTTGTAACT
CTCCGCTTCTCCCCCCCCTTTCGA -> TCCGCTTCTCCCCCCCCTTTCGAA
CAGTGGTGTGCTCGAATAGCATAA -> AGTGGTGTGCTCGAATAGCATAAA
TCGCCCGTTCTTCTGTGGTAACTA -> CGCCCGTTCTTCTGTGGTAACTAG
GAATTTAGGGGGTTACAAACTTGA -> AATTTAGGGGGTTACAAACTTGAA
CACTTGGAAGTGCGATACCGTGGC -> ACTTGGAAGTGCGATACCGTGGCC
CCAACCTAGACCCGTGCTTAGAGC -> CAACCTAGACCCGTGCTTAGAGCA
TAATGCCACAACAGAAGTCGGCAT -> AATGCCACAACAGAAGTCGGCATG
GGTAACTAGAGTCCATAAACATGT -> GTAACTAGAGTCCATAAACATGTT
CTCCGACGCCGATTGTGAGGATAA -> TCCGACGCCGATTGTGAGGATAAA
TAACCCCCCAATATACTTAGGCGT -> AACCCCCCAATATACTTAGGCGTA
CGGTGAAGCTTACAGCCATTGACG -> GGTGAAGCTTACAGCCATTGACGC
CGTGCTTAGAGCAGTAAAAACGCA -> GTGCTTAGAGCAGTAAAAACGCAA
ACACTTGCAACTGAACTTTCGAAA -> CACTTGCAACTGAACTTTCGAAAG
AGTAAGAGATCCGGATTGTGAGGG -> GTAAGAGATCCGGATTGTGAGGGC
TTTGAACGCCGAAAGTCCGCCGGC -> TTGAACGCCGAAAGTCCGCCGGCG
GCCCGTTCTTCTGTGGTAACTAGA -> CCCGTTCTTCTGTGGTAACTAGAG
CCTTTGGAAACTGCTCGTTCTCTG -> CTTTGGAAACTGCTCGTTCTCTGC
CTTCCAAGTGACATGACCTTGAGG -> TTCCAAGTGACATGACCTTGAGGT
ATCTTTCCGGGCGAGTCCGGCATG -> TCTTTCCGGGCGAGTCCGGCATGT
CAATAGAAAAATCAGAGCATCCCT -> AATAGAAAAATCAGAGCATCCCTA
TACAAACTTGAACCTCTTAACGGT -> ACAAACTTGAACCTCTTAACGGTT
AAAGACTTATAGTGTCTTCACGTC -> AAGACTTATAGTGTCTTCACGTCC
AGAGCAGTAAAAACGCAATTAGGC -> GAGCAGTAAAAACGCAATTAGGCG
TGACATGACCTTGAGGTCGTCTGG -> GACATGACCTTGAGGTCGTCTGGT
CTGGGGTCGGGCCTGCTCGCCAAC -> TGGGGTCGGGCCTGCTCGCCAACT
AAACGGTGAAGCTTACAGCCATTG -> AACGGTGAAGCTTACAGCCATTGA
CGTAAGAGAGCTTACCCTATCTAC -> GTAAGAGAGCTTACCCTATCTACA
ACAAACTTGAACCTCTTAACGGTT -> CAAACTTGAACCTCTTAACGGTTC
CGAATTTTCAAGGGTCTTCATAAG -> GAATTTTCAAGGGTCTTCATAAGT
ATGAGAACGCCTCATCTTTCCGGG -> TGAGAACGCCTCATCTTTCCGGGC
TTGCAACTGAACTTTCGAAAGCGA -> TGCAACTGAACTTTCGAAAGCGAT
CCCCCCCTTTCGAATTTTCAAGGG -> CCCCCCTTTCGAATTTTCAAGGGT
ATAATTCTCTTGGACACTTGTTAC -> TAATTCTCTTGGACACTTGTTACG
AAAGCGCTGCCCTGTAAAGTAAGA -> AAGCGCTGCCCTGTAAAGTAAGAG
TGTCGATCAGGGTGTAGTCGCCTC -> GTCGATCAGGGTGTAGTCGCCTCC
CCACAACAGAAGTCGGCATGCCTG -> CACAACAGAAGTCGGCATGCCTGG
AGAAGTCGGCATGCCTGGCTTAGG -> GAAGTCGGCATGCCTGGCTTAGGG
GCAAATGAATATAGAGATGAGGAT -> CAAATGAATATAGAGATGAGGATC
TTAGCCGGTTTGAACGCCGAAAGT -> TAGCCGGTTTGAACGCCGAAAGTC
TGCTTTATCCTCTTAGTGATTGTA -> GCTTTATCCTCTTAGTGATTGTAT
ATCCAGTCATGCTGGGGTCGGGCC -> TCCAGTCATGCTGGGGTCGGGCCT
AAGGCTGGCGCGATAGTAGATGAG -> AGGCTGGCGCGATAGTAGATGAGT
TCGGGCCTGCTCGCCAACTCGCCA -> CGGGCCTGCTCGCCAACTCGCCAA
AAGTCTAGGGAATTATCGTCACTA -> AGTCTAGGGAATTATCGTCACTAG
TTCGCTCAGCCAGAAGATTGTATG -> TCGCTCAGCCAGAAGATTGTATGC
GGTGCCTCTACAGCCGGCCTTTGG -> GTGCCTCTACAGCCGGCCTTTGGA
ACTCCGCTTCTCCCCCCCCTTTCG -> CTCCGCTTCTCCCCCCCCTTTCGA
ACGTCCATGAGAACGCCTCATCTT -> CGTCCATGAGAACGCCTCATCTTT
TTGTCTGGGACGAAGTCGGCCTTA -> TGTCTGGGACGAAGTCGGCCTTAT
CATGGCACCTTTAGACTCCCGACA -> ATGGCACCTTTAGACTCCCGACAG
AGCCGGCCTTTGGAAACTGCTCGT -> GCCGGCCTTTGGAAACTGCTCGTT
TAGGCGGGAGCGCCACAGTTGAAT -> AGGCGGGAGCGCCACAGTTGAATT
ATGAACCATTTCAAAGGCCACTAT -> TGAACCATTTCAAAGGCCACTATA
CCCATTGGAGATGCCGTCGCTCCG -> CCATTGGAGATGCCGTCGCTCCGG
ACGCTAACTTACTAAGCCGGTACG -> CGCTAACTTACTAAGCCGGTACGT
GCTCTACGTGGCCGTGTTCACATG -> CTCTACGTGGCCGTGTTCACATGG
TCGCTCCGTACAAGCCCATTGGAG -> CGCTCCGTACAAGCCCATTGGAGA
TTTAGACTCCCGACAGCCCGTAAA -> TTAGACTCCCGACAGCCCGTAAAA
CCATTCCCATCAACCTTGCTTTAT -> CATTCCCATCAACCTTGCTTTATC
GACTCCAATCAGGTGCTTTTTTAG -> ACTCCAATCAGGTGCTTTTTTAGC
TGTCTATACAGGATTGCGGTGTGC -> GTCTATACAGGATTGCGGTGTGCT
ATCTCCGTAACTTCAAGCCGTGTG -> TCTCCGTAACTTCAAGCCGTGTGA
CCGTACAAGCCCATTGGAGATGCC -> CGTACAAGCCCATTGGAGATGCCG
CACCCGTGGTACAACCTCCCGGAC -> ACCCGTGGTACAACCTCCCGGACT
ACTATCTCGTTACGGAACCGGAAC -> CTATCTCGTTACGGAACCGGAACG
GCATCTTCACGTATCTGTAGAACA -> CATCTTCACGTATCTGTAGAACAT
TCGCCAAGATCTATACCCTTGTCT -> CGCCAAGATCTATACCCTTGTCTG
GCGCGATAGTAGATGAGTGCAATA -> CGCGATAGTAGATGAGTGCAATAT
GCTTAGGGTTTCACTATCTCGTTA -> CTTAGGGTTTCACTATCTCGTTAC
CTATCTACATTTACAGCCGGGTTG -> TATCTACATTTACAGCCGGGTTGA
GTTACAAACTTGAACCTCTTAACG -> TTACAAACTTGAACCTCTTAACGG
CTAAAGACTTATAGTGTCTTCACG -> TAAAGACTTATAGTGTCTTCACGT
CTAGACGCGAATGTCGTTTGCGCC -> TAGACGCGAATGTCGTTTGCGCCC
ACACGACCGCTCATGGTACGACCG -> CACGACCGCTCATGGTACGACCGA
TGAACGCCGAAAGTCCGCCGGCGA -> GAACGCCGAAAGTCCGCCGGCGAC
TAGTGATTGTATTTCTAGTTCCCT -> AGTGATTGTATTTCTAGTTCCCTG
TCCAATCAGGTGCTTTTTTAGCAC -> CCAATCAGGTGCTTTTTTAGCACA
GACCACTATGAACCATTTCAAAGG -> ACCACTATGAACCATTTCAAAGGC
GTCGTTTGCGCCCTTGGTGCCTCT -> TCGTTTGCGCCCTTGGTGCCTCTA
TTCTCTGCTTTAAATGTTAGCCGG -> TCTCTGCTTTAAATGTTAGCCGGT
TTTCGAATTTTCAAGGGTCTTCAT -> TTCGAATTTTCAAGGGTCTTCATA
AAATCAGAGCATCCCTAAGCTTCC -> AATCAGAGCATCCCTAAGCTTCCA
CAGCCAGAAGATTGTATGCGGCCC -> AGCCAGAAGATTGTATGCGGCCCC
GTCCATAAACATGTTCTTCGTTAT -> TCCATAAACATGTTCTTCGTTATT
TTTCAAGGGTCTTCATAAGTGTCT -> TTCAAGGGTCTTCATAAGTGTCTA
AGCCCATTGGAGATGCCGTCGCTC -> GCCCATTGGAGATGCCGTCGCTCC
GGGAATTATCGTCACTAGTGATGT -> GGAATTATCGTCACTAGTGATGTG
AATATACTTAGGCGTAAGAGAGCT -> ATATACTTAGGCGTAAGAGAGCTT
TCCGCCGGCGACTGATAACACTTG -> CCGCCGGCGACTGATAACACTTGC
TATTCGCTCAGCCAGAAGATTGTA -> ATTCGCTCAGCCAGAAGATTGTAT
CGATAATCCAGTCATGCTGGGGTC -> GATAATCCAGTCATGCTGGGGTCG
CTTAGTGATTGTATTTCTAGTTCC -> TTAGTGATTGTATTTCTAGTTCCC
TAACACTTGCAACTGAACTTTCGA -> AACACTTGCAACTGAACTTTCGAA
ACCTTGAGGTCGTCTGGTCGACAA -> CCTTGAGGTCGTCTGGTCGACAAA
ACAGATAATTCTCTTGGACACTTG -> CAGATAATTCTCTTGGACACTTGT
GAACGTAGAAGGTAATACCCCAAG -> AACGTAGAAGGTAATACCCCAAGG
AGAGTCCATAAACATGTTCTTCGT -> GAGTCCATAAACATGTTCTTCGTT
ATAAATTCGAACACGACCGCTCAT -> TAAATTCGAACACGACCGCTCATG
TCTGTAGAACATTGGAAGACCTCG -> CTGTAGAACATTGGAAGACCTCGC
TGTGAGGATAAACCCTACAGCACA -> GTGAGGATAAACCCTACAGCACAA
TACTCCCTCAAGTCTAGGGAATTA -> ACTCCCTCAAGTCTAGGGAATTAT
CTCAAGTCTAGGGAATTATCGTCA -> TCAAGTCTAGGGAATTATCGTCAC
AGCCATACTCCGCTTCTCCCCCCC -> GCCATACTCCGCTTCTCCCCCCCC
ACTTCGTTCCCCCACATCGCTAAA -> CTTCGTTCCCCCACATCGCTAAAG
TAGTAACTCCTGGTCGCTCCGTAC -> AGTAACTCCTGGTCGCTCCGTACA
GCTCCGGAACGGGTCTACGGCCAC -> CTCCGGAACGGGTCTACGGCCACG
AAGGTTACTACCGCGACAGCTTTT -> AGGTTACTACCGCGACAGCTTTTC
GCTGGCGCGATAGTAGATGAGTGC -> CTGGCGCGATAGTAGATGAGTGCA
ACGCTTCACCCTATGCACCCGTGG -> CGCTTCACCCTATGCACCCGTGGT
AGCAGCTCTACGTGGCCGTGTTCA -> GCAGCTCTACGTGGCCGTGTTCAC
GTTATTACAATACTCCCTCAAGTC -> TTATTACAATACTCCCTCAAGTCT
CCCGTAAAAGCATCTTCACGTATC -> CCGTAAAAGCATCTTCACGTATCT
GACAGCCCGTAAAAGCATCTTCAC -> ACAGCCCGTAAAAGCATCTTCACG
CAGAGCATCCCTAAGCTTCCAAGT -> AGAGCATCCCTAAGCTTCCAAGTG
GGTGTGCTTGACCACCTTAGCATA -> GTGTGCTTGACCACCTTAGCATAA
ATTCCTAATCCCAAGCCATACTCC -> TTCCTAATCCCAAGCCATACTCCG
GAATTATCGTCACTAGTGATGTGT -> AATTATCGTCACTAGTGATGTGTC
GCTCATGGTACGACCGAGCGCATG -> CTCATGGTACGACCGAGCGCATGG
AAGGCCTATCCGAAACGACATGAC -> AGGCCTATCCGAAACGACATGACT
GTCCGTGCTTCGCCCGTTCTTCTG -> TCCGTGCTTCGCCCGTTCTTCTGT
GCTTCACCCTATGCACCCGTGGTA -> CTTCACCCTATGCACCCGTGGTAC
GCGGTCTGTCAGTGGTGTGCTCGA -> CGGTCTGTCAGTGGTGTGCTCGAA
CAAATGAATATAGAGATGAGGATC -> AAATGAATATAGAGATGAGGATCG
CCCTGTAAAGTAAGAGATCCGGAT -> CCTGTAAAGTAAGAGATCCGGATT
CGCTCATGGTACGACCGAGCGCAT -> GCTCATGGTACGACCGAGCGCATG
AAGTCGGCCTTATTCCCTCGTTCA -> AGTCGGCCTTATTCCCTCGTTCAA
TCTGCTTTAAATGTTAGCCGGTTT -> CTGCTTTAAATGTTAGCCGGTTTG
CCTAGACCCGTGCTTAGAGCAGTA -> CTAGACCCGTGCTTAGAGCAGTAA
GCTTTTCGTAACATTTCTCCGACG -> CTTTTCGTAACATTTCTCCGACGC
GTAAAAGCATCTTCACGTATCTGT -> TAAAAGCATCTTCACGTATCTGTA
ACCGCTCATGGTACGACCGAGCGC -> CCGCTCATGGTACGACCGAGCGCA
GAATTGATAAACGGTGAAGCTTAC -> AATTGATAAACGGTGAAGCTTACA
ACGTGGTGGGACCACTATGAACCA -> CGTGGTGGGACCACTATGAACCAT
TTAGACTCCCGACAGCCCGTAAAA -> TAGACTCCCGACAGCCCGTAAAAG
CAACTCGCCAATTCCGTTTAAGTC -> AACTCGCCAATTCCGTTTAAGTCG
TATACGCCCGGTAGAAGTCTGAAT -> ATACGCCCGGTAGAAGTCTGAATT
AAAAACGCAATTAGGCGGGAGCGC -> AAAACGCAATTAGGCGGGAGCGCC
AGGGGGTTACAAACTTGAACCTCT -> GGGGGTTACAAACTTGAACCTCTT
TCCTCTTAGTGATTGTATTTCTAG -> CCTCTTAGTGATTGTATTTCTAGT
GGATGTTACTAGACGCGAATGTCG -> GATGTTACTAGACGCGAATGTCGT
CGAAAGTCCGCCGGCGACTGATAA -> GAAAGTCCGCCGGCGACTGATAAC
GGAGATGCCGTCGCTCCGGAACGG -> GAGATGCCGTCGCTCCGGAACGGG
ATATCCTGGACTTACAGACTGTTT -> TATCCTGGACTTACAGACTGTTTA
TCTTCACGTATCTGTAGAACATTG -> CTTCACGTATCTGTAGAACATTGG
TCATAAGTGTCTATACAGGATTGC -> CATAAGTGTCTATACAGGATTGCG
CGTCCGTGCTTCGCCCGTTCTTCT -> GTCCGTGCTTCGCCCGTTCTTCTG
ATATATTCGCTCAGCCAGAAGATT -> TATATTCGCTCAGCCAGAAGATTG
TACCCTTGTCTGGGACGAAGTCGG -> ACCCTTGTCTGGGACGAAGTCGGC
GGTGAAGCTTACAGCCATTGACGC -> GTGAAGCTTACAGCCATTGACGCC
TTGGTGCCTCTACAGCCGGCCTTT -> TGGTGCCTCTACAGCCGGCCTTTG
TGGATGTTACTAGACGCGAATGTC -> GGATGTTACTAGACGCGAATGTCG
TACCGCGACAGCTTTTCGTAACAT -> ACCGCGACAGCTTTTCGTAACATT
GCAACTGAACTTTCGAAAGCGATC -> CAACTGAACTTTCGAAAGCGATCC
ACCCCCCAATATACTTAGGCGTAA -> CCCCCCAATATACTTAGGCGTAAG
CCCCAATATACTTAGGCGTAAGAG -> CCCAATATACTTAGGCGTAAGAGA
GGCCACATGCTGCATCCTGATGTG -> GCCACATGCTGCATCCTGATGTGT
GTACGCTGGCGGCTCCTGACGCTA -> TACGCTGGCGGCTCCTGACGCTAA
AGAGAGCTTACCCTATCTACATTT -> GAGAGCTTACCCTATCTACATTTA
ACGGTTCAAGAGCTAACCCCCCAA -> CGGTTCAAGAGCTAACCCCCCAAT
AGAGCACAGAAGAATTCTCGAAGC -> GAGCACAGAAGAATTCTCGAAGCA
GATCGGCACGTGGTGGGACCACTA -> ATCGGCACGTGGTGGGACCACTAT
AGAGCATCCCTAAGCTTCCAAGTG -> GAGCATCCCTAAGCTTCCAAGTGA
CGGCGACTGATAACACTTGCAACT -> GGCGACTGATAACACTTGCAACTG
TAAACCCTACAGCACAACGTCCCA -> AAACCCTACAGCACAACGTCCCAA
AAACTTGAACCTCTTAACGGTTCA -> AACTTGAACCTCTTAACGGTTCAA
TCTACATTTACAGCCGGGTTGAAT -> CTACATTTACAGCCGGGTTGAATA
CTAAGCCGGTACGTCCAATACGGA -> TAAGCCGGTACGTCCAATACGGAC
CCTGGTCGCTCCGTACAAGCCCAT -> CTGGTCGCTCCGTACAAGCCCATT
GGTGCTGTTAAAGCTGGTCGAGTG -> GTGCTGTTAAAGCTGGTCGAGTGA
CTCTTAACGGTTCAAGAGCTAACC -> TCTTAACGGTTCAAGAGCTAACCC
ACTCGCCAATTCCGTTTAAGTCGC -> CTCGCCAATTCCGTTTAAGTCGCC
CGATAGGACGGCGATCAGTACTGA -> GATAGGACGGCGATCAGTACTGAA
CACGTATCTGTAGAACATTGGAAG -> ACGTATCTGTAGAACATTGGAAGA
TGTTACGAGCAGCTCTACGTGGCC -> GTTACGAGCAGCTCTACGTGGCCG
TGGAAGACCTCGCAAATGAATATA -> GGAAGACCTCGCAAATGAATATAG
TCATGGTACGACCGAGCGCATGGC -> CATGGTACGACCGAGCGCATGGCA
AAGCCATACTCCGCTTCTCCCCCC -> AGCCATACTCCGCTTCTCCCCCCC
AACCGATATATATTCGCTCAGCCA -> ACCGATATATATTCGCTCAGCCAG
TATCTGTAGAACATTGGAAGACCT -> ATCTGTAGAACATTGGAAGACCTC
CTGGTCGACAAATCTCCGTAACTT -> TGGTCGACAAATCTCCGTAACTTC
TGCGCCCTTGGTGCCTCTACAGCC -> GCGCCCTTGGTGCCTCTACAGCCG
AGCATAAATTCGAACACGACCGCT -> GCATAAATTCGAACACGACCGCTC
CTTGTCTGGGACGAAGTCGGCCTT -> TTGTCTGGGACGAAGTCGGCCTTA
ACCCGTGGTACAACCTCCCGGACT -> CCCGTGGTACAACCTCCCGGACTG
AGTCCGGCATGTTAGAGCACAGAA -> GTCCGGCATGTTAGAGCACAGAAG
CGACTGATAACACTTGCAACTGAA -> GACTGATAACACTTGCAACTGAAC
GGCACCTTTAGACTCCCGACAGCC -> GCACCTTTAGACTCCCGACAGCCC
TGCTTTAAATGTTAGCCGGTTTGA -> GCTTTAAATGTTAGCCGGTTTGAA
ACATGACTCCAATCAGGTGCTTTT -> CATGACTCCAATCAGGTGCTTTTT
GCCGGCCTTTGGAAACTGCTCGTT -> CCGGCCTTTGGAAACTGCTCGTTC
TAAGTCGCCAAGATCTATACCCTT -> AAGTCGCCAAGATCTATACCCTTG
TGACTCCAATCAGGTGCTTTTTTA -> GACTCCAATCAGGTGCTTTTTTAG
GATTGTATGCGGCCCCATTCCCAT -> ATTGTATGCGGCCCCATTCCCATC
GTGCTTTTTTAGCACACATGTATT -> TGCTTTTTTAGCACACATGTATTC
TTGTGAGGATAAACCCTACAGCAC -> TGTGAGGATAAACCCTACAGCACA
GCGCCCTTGGTGCCTCTACAGCCG -> CGCCCTTGGTGCCTCTACAGCCGG
AATAGAAAAATCAGAGCATCCCTA -> ATAGAAAAATCAGAGCATCCCTAA
AATCCAGTCATGCTGGGGTCGGGC -> ATCCAGTCATGCTGGGGTCGGGCC
TCAAGCCGTGTGACTTCGTTCCCC -> CAAGCCGTGTGACTTCGTTCCCCC
GTGTGACTTCGTTCCCCCACATCG -> TGTGACTTCGTTCCCCCACATCGC
AGCCCGTAAAAGCATCTTCACGTA -> GCCCGTAAAAGCATCTTCACGTAT
AACCATTTCAAAGGCCACTATACG -> ACCATTTCAAAGGCCACTATACGC
AAGAGCTAACCCCCCAATATACTT -> AGAGCTAACCCCCCAATATACTTA
GCAGCTCTACGTGGCCGTGTTCAC -> CAGCTCTACGTGGCCGTGTTCACA
GACTGTAGTAACTCCTGGTCGCTC -> ACTGTAGTAACTCCTGGTCGCTCC
AGCCGGTTTGAACGCCGAAAGTCC -> GCCGGTTTGAACGCCGAAAGTCCG
ATTGTATGCGGCCCCATTCCCATC -> TTGTATGCGGCCCCATTCCCATCA
ATACCGTGGCCGGTCATTAAAAGC -> TACCGTGGCCGGTCATTAAAAGCG
AACTCGCCAATTCCGTTTAAGTCG -> ACTCGCCAATTCCGTTTAAGTCGC
AACGACATGACTCCAATCAGGTGC -> ACGACATGACTCCAATCAGGTGCT
CGTTCTTCTGTGGTAACTAGAGTC -> GTTCTTCTGTGGTAACTAGAGTCC
AGGATTGCGGTGTGCTTGACCACC -> GGATTGCGGTGTGCTTGACCACCT
TGAACCTCTTAACGGTTCAAGAGC -> GAACCTCTTAACGGTTCAAGAGCT
AAGCTTACAGCCATTGACGCCATA -> AGCTTACAGCCATTGACGCCATAC
CGCTGCCCTGTAAAGTAAGAGATC -> GCTGCCCTGTAAAGTAAGAGATCC
TAGTGTCTTCACGTCCATGAGAAC -> AGTGTCTTCACGTCCATGAGAACG
TGGAAACTGCTCGTTCTCTGCTTT -> GGAAACTGCTCGTTCTCTGCTTTA
AGTGAATTTTGTCGATCAGGGTGT -> GTGAATTTTGTCGATCAGGGTGTA
CCGTGCTTAGAGCAGTAAAAACGC -> CGTGCTTAGAGCAGTAAAAACGCA
TTCACTATCTCGTTACGGAACCGG -> TCACTATCTCGTTACGGAACCGGA
CTTTCGAAAGCGATCCAACCTAGA -> TTTCGAAAGCGATCCAACCTAGAC
CTGTTAAAGCTGGTCGAGTGAAGG -> TGTTAAAGCTGGTCGAGTGAAGGC
GTTTGAACGCCGAAAGTCCGCCGG -> TTTGAACGCCGAAAGTCCGCCGGC
CACGATAATCCAGTCATGCTGGGG -> ACGATAATCCAGTCATGCTGGGGT
TAGTAGATGAGTGCAATATGAAGT -> AGTAGATGAGTGCAATATGAAGTC
AGTTGAATTGATAAACGGTGAAGC -> GTTGAATTGATAAACGGTGAAGCT
AGCTGGTCGAGTGAAGGCCTATCC -> GCTGGTCGAGTGAAGGCCTATCCG
ACTGTTTAAGGTTACTACCGCGAC -> CTGTTTAAGGTTACTACCGCGACA
CTTCGCCCGTTCTTCTGTGGTAAC -> TTCGCCCGTTCTTCTGTGGTAACT
TGATAACACTTGCAACTGAACTTT -> GATAACACTTGCAACTGAACTTTC
CAAACTTGAACCTCTTAACGGTTC -> AAACTTGAACCTCTTAACGGTTCA
ATCGGCACGTGGTGGGACCACTAT -> TCGGCACGTGGTGGGACCACTATG
ACCCGATAGGACGGCGATCAGTAC -> CCCGATAGGACGGCGATCAGTACT
GCCACGATAATCCAGTCATGCTGG -> CCACGATAATCCAGTCATGCTGGG
AACTGAAATGAAATTCCTAATCCC -> ACTGAAATGAAATTCCTAATCCCA
CTGAAATGAAATTCCTAATCCCAA -> TGAAATGAAATTCCTAATCCCAAG
CTTGGAAGTGCGATACCGTGGCCG -> TTGGAAGTGCGATACCGTGGCCGG
GGCGGCTCCTGACGCTAACTTACT -> GCGGCTCCTGACGCTAACTTACTA
TTGGAAGACCTCGCAAATGAATAT -> TGGAAGACCTCGCAAATGAATATA
CCGACAGCCCGTAAAAGCATCTTC -> CGACAGCCCGTAAAAGCATCTTCA
AACCCCCCAATATACTTAGGCGTA -> ACCCCCCAATATACTTAGGCGTAA
GCACGTGGTGGGACCACTATGAAC -> CACGTGGTGGGACCACTATGAACC
CCCCACATCGCTAAAGACTTATAG -> CCCACATCGCTAAAGACTTATAGT
CGTTCCCCCACATCGCTAAAGACT -> GTTCCCCCACATCGCTAAAGACTT
GTCACTAGTGATGTGTCCTGTGTC -> TCACTAGTGATGTGTCCTGTGTCA
TCACGTATCTGTAGAACATTGGAA -> CACGTATCTGTAGAACATTGGAAG
GGTCATTAAAAGCGCTGCCCTGTA -> GTCATTAAAAGCGCTGCCCTGTAA
CTGCAAGCTTAGCAGGCCACATGC -> TGCAAGCTTAGCAGGCCACATGCT
CACCCGATAGGACGGCGATCAGTA -> ACCCGATAGGACGGCGATCAGTAC
CCCTCAAGTCTAGGGAATTATCGT -> CCTCAAGTCTAGGGAATTATCGTC
TCCGTTTAAGTCGCCAAGATCTAT -> CCGTTTAAGTCGCCAAGATCTATA
TTGGAAACTGCTCGTTCTCTGCTT -> TGGAAACTGCTCGTTCTCTGCTTT
TGTAAAGTAAGAGATCCGGATTGT -> GTAAAGTAAGAGATCCGGATTGTG
GAGACCGCCGTCAAACCGATATAT -> AGACCGCCGTCAAACCGATATATA
CATCAACCTTGCTTTATCCTCTTA -> ATCAACCTTGCTTTATCCTCTTAG
TAGCCGGTTTGAACGCCGAAAGTC -> AGCCGGTTTGAACGCCGAAAGTCC
TAAAGCTGGTCGAGTGAAGGCCTA -> AAAGCTGGTCGAGTGAAGGCCTAT
CTTACTAAGCCGGTACGTCCAATA -> TTACTAAGCCGGTACGTCCAATAC
ATTTACAGCCGGGTTGAATATAAT -> TTTACAGCCGGGTTGAATATAATG
CGGTCATTAAAAGCGCTGCCCTGT -> GGTCATTAAAAGCGCTGCCCTGTA
TTTACAGCCGGGTTGAATATAATG -> TTACAGCCGGGTTGAATATAATGC
CGGCCTTATTCCCTCGTTCAACAC -> GGCCTTATTCCCTCGTTCAACACA
AAAGCGATCCAACCTAGACCCGTG -> AAGCGATCCAACCTAGACCCGTGC
TACAATACTCCCTCAAGTCTAGGG -> ACAATACTCCCTCAAGTCTAGGGA
TACAGCCGGCCTTTGGAAACTGCT -> ACAGCCGGCCTTTGGAAACTGCTC
GGAATTATCGTCACTAGTGATGTG -> GAATTATCGTCACTAGTGATGTGT
ATTCGAACACGACCGCTCATGGTA -> TTCGAACACGACCGCTCATGGTAC
TGACTTCGTTCCCCCACATCGCTA -> GACTTCGTTCCCCCACATCGCTAA
ATATAATGCCACAACAGAAGTCGG -> TATAATGCCACAACAGAAGTCGGC
CAACAGAAGTCGGCATGCCTGGCT -> AACAGAAGTCGGCATGCCTGGCTT
CCCCCTTTCGAATTTTCAAGGGTC -> CCCCTTTCGAATTTTCAAGGGTCT
GAAGGCCTATCCGAAACGACATGA -> AAGGCCTATCCGAAACGACATGAC
CGGCCTTTGGAAACTGCTCGTTCT -> GGCCTTTGGAAACTGCTCGTTCTC
CACGACCGCTCATGGTACGACCGA -> ACGACCGCTCATGGTACGACCGAG
TCCAACCTAGACCCGTGCTTAGAG -> CCAACCTAGACCCGTGCTTAGAGC
GCGGCCCCATTCCCATCAACCTTG -> CGGCCCCATTCCCATCAACCTTGC
GAGGATCGGCACGTGGTGGGACCA -> AGGATCGGCACGTGGTGGGACCAC
GCACCTTTAGACTCCCGACAGCCC -> CACCTTTAGACTCCCGACAGCCCG
CCATACGTCCGTGCTTCGCCCGTT -> CATACGTCCGTGCTTCGCCCGTTC
GGTCTGTCAGTGGTGTGCTCGAAT -> GTCTGTCAGTGGTGTGCTCGAATA
GGCAGGGTGCTGTTAAAGCTGGTC -> GCAGGGTGCTGTTAAAGCTGGTCG
CAAGCCCATTGGAGATGCCGTCGC -> AAGCCCATTGGAGATGCCGTCGCT
TGTTACTAGACGCGAATGTCGTTT -> GTTACTAGACGCGAATGTCGTTTG
TGTAACTGAAATGAAATTCCTAAT -> GTAACTGAAATGAAATTCCTAATC
TTGTTACGAGCAGCTCTACGTGGC -> TGTTACGAGCAGCTCTACGTGGCC
TGGACACTTGTTACGAGCAGCTCT -> GGACACTTGTTACGAGCAGCTCTA
TTGACGCCATACGTCCGTGCTTCG -> TGACGCCATACGTCCGTGCTTCGC
TGTCAACCGGGATGTACGCTGGCG -> GTCAACCGGGATGTACGCTGGCGG
CTCCTGGTCGCTCCGTACAAGCCC -> TCCTGGTCGCTCCGTACAAGCCCA
TCTTGGACACTTGTTACGAGCAGC -> CTTGGACACTTGTTACGAGCAGCT
GGGGGTTACAAACTTGAACCTCTT -> GGGGTTACAAACTTGAACCTCTTA
GGCCGTGTTCACATGGATGTTACT -> GCCGTGTTCACATGGATGTTACTA
GATTGTGAGGGCGTCAATATCCTG -> ATTGTGAGGGCGTCAATATCCTGG
CTGTGCATCAGTGAATTTTGTCGA -> TGTGCATCAGTGAATTTTGTCGAT
GCTGCAAGCTTAGCAGGCCACATG -> CTGCAAGCTTAGCAGGCCACATGC
ACAGCCGGGTTGAATATAATGCCA -> CAGCCGGGTTGAATATAATGCCAC
GCGACAGCTTTTCGTAACATTTCT -> CGACAGCTTTTCGTAACATTTCTC
CGGACGTTTGTTGTAACTGAAATG -> GGACGTTTGTTGTAACTGAAATGA
GAACGGGTCTACGGCCACGATAAT -> AACGGGTCTACGGCCACGATAATC
CGAAAGCGATCCAACCTAGACCCG -> GAAAGCGATCCAACCTAGACCCGT
TAGACTCCCGACAGCCCGTAAAAG -> AGACTCCCGACAGCCCGTAAAAGC
AGCAGGCCACATGCTGCATCCTGA -> GCAGGCCACATGCTGCATCCTGAT
AGATCCGGATTGTGAGGGCGTCAA -> GATCCGGATTGTGAGGGCGTCAAT
ATGCTGGGGTCGGGCCTGCTCGCC -> TGCTGGGGTCGGGCCTGCTCGCCA
ATCTACATTTACAGCCGGGTTGAA -> TCTACATTTACAGCCGGGTTGAAT
TGCTGGGGTCGGGCCTGCTCGCCA -> GCTGGGGTCGGGCCTGCTCGCCAA
CCCTACAGCACAACGTCCCAACTA -> CCTACAGCACAACGTCCCAACTAG
CTCTTGGACACTTGTTACGAGCAG -> TCTTGGACACTTGTTACGAGCAGC
GTGAAGGCCTATCCGAAACGACAT -> TGAAGGCCTATCCGAAACGACATG
ATCCTCTTAGTGATTGTATTTCTA -> TCCTCTTAGTGATTGTATTTCTAG
AGGTTACTACCGCGACAGCTTTTC -> GGTTACTACCGCGACAGCTTTTCG
GGAGCGCCACAGTTGAATTGATAA -> GAGCGCCACAGTTGAATTGATAAA
CATGCCTGGCTTAGGGTTTCACTA -> ATGCCTGGCTTAGGGTTTCACTAT
GAGCGCATGGCACCTTTAGACTCC -> AGCGCATGGCACCTTTAGACTCCC
ACTAGTGATGTGTCCTGTGTCAGC -> CTAGTGATGTGTCCTGTGTCAGCA
TCTTAGTGATTGTATTTCTAGTTC -> CTTAGTGATTGTATTTCTAGTTCC
TTTAAGTCGCCAAGATCTATACCC -> TTAAGTCGCCAAGATCTATACCCT
GATCTATACCCTTGTCTGGGACGA -> ATCTATACCCTTGTCTGGGACGAA
TTTTCGTAACATTTCTCCGACGCC -> TTTCGTAACATTTCTCCGACGCCG
CTGGACTTACAGACTGTTTAAGGT -> TGGACTTACAGACTGTTTAAGGTT
CTTAACGGTTCAAGAGCTAACCCC -> TTAACGGTTCAAGAGCTAACCCCC
TGGCTTAGGGTTTCACTATCTCGT -> GGCTTAGGGTTTCACTATCTCGTT
CCTCATCTTTCCGGGCGAGTCCGG -> CTCATCTTTCCGGGCGAGTCCGGC
ATTTCTCCGACGCCGATTGTGAGG -> TTTCTCCGACGCCGATTGTGAGGA
ACATTTACAGCCGGGTTGAATATA -> CATTTACAGCCGGGTTGAATATAA
AGGGAATTATCGTCACTAGTGATG -> GGGAATTATCGTCACTAGTGATGT
TGGTACGACCGAGCGCATGGCACC -> GGTACGACCGAGCGCATGGCACCT
AAGTAAGAGATCCGGATTGTGAGG -> AGTAAGAGATCCGGATTGTGAGGG
TCTCCCCCCCCTTTCGAATTTTCA -> CTCCCCCCCCTTTCGAATTTTCAA
TCAAGTCTAGGGAATTATCGTCAC -> CAAGTCTAGGGAATTATCGTCACT
GCATGGCACCTTTAGACTCCCGAC -> CATGGCACCTTTAGACTCCCGACA
TCGACAAATCTCCGTAACTTCAAG -> CGACAAATCTCCGTAACTTCAAGC
CGACATGACTCCAATCAGGTGCTT -> GACATGACTCCAATCAGGTGCTTT
GATGAGTGCAATATGAAGTCGGCA -> ATGAGTGCAATATGAAGTCGGCAG
CCCATTCCCATCAACCTTGCTTTA -> CCATTCCCATCAACCTTGCTTTAT
TCGTTCCCCCACATCGCTAAAGAC -> CGTTCCCCCACATCGCTAAAGACT
TCTACAGCCGGCCTTTGGAAACTG -> CTACAGCCGGCCTTTGGAAACTGC
CCTCGTTCAACACAGATAATTCTC -> CTCGTTCAACACAGATAATTCTCT
CTTGCAACTGAACTTTCGAAAGCG -> TTGCAACTGAACTTTCGAAAGCGA
CTTCGTTCCCCCACATCGCTAAAG -> TTCGTTCCCCCACATCGCTAAAGA
CCTATCTACATTTACAGCCGGGTT -> CTATCTACATTTACAGCCGGGTTG
TTTCGAAAGCGATCCAACCTAGAC -> TTCGAAAGCGATCCAACCTAGACC
TGAACCATTTCAAAGGCCACTATA -> GAACCATTTCAAAGGCCACTATAC
ACAGACTGTTTAAGGTTACTACCG -> CAGACTGTTTAAGGTTACTACCGC
GCATAAATTCGAACACGACCGCTC -> CATAAATTCGAACACGACCGCTCA
TTCCGGGCGAGTCCGGCATGTTAG -> TCCGGGCGAGTCCGGCATGTTAGA
TATACAGGATTGCGGTGTGCTTGA -> ATACAGGATTGCGGTGTGCTTGAC
CCTCTACAGCCGGCCTTTGGAAAC -> CTCTACAGCCGGCCTTTGGAAACT
GCCATTGACGCCATACGTCCGTGC -> CCATTGACGCCATACGTCCGTGCT
AGCATCTTCACGTATCTGTAGAAC -> GCATCTTCACGTATCTGTAGAACA
CCACTATACGCCCGGTAGAAGTCT -> CACTATACGCCCGGTAGAAGTCTG
AGTCATGCTGGGGTCGGGCCTGCT -> GTCATGCTGGGGTCGGGCCTGCTC
CCTGATGTGTCATACCAATAGAAA -> CTGATGTGTCATACCAATAGAAAA
ACTAGAGACCGCCGTCAAACCGAT -> CTAGAGACCGCCGTCAAACCGATA
GGTGTAGTCGCCTCCTCACCCGAT -> GTGTAGTCGCCTCCTCACCCGATA
CCCGTGGTACAACCTCCCGGACTG -> CCGTGGTACAACCTCCCGGACTGT
AACACTTGCAACTGAACTTTCGAA -> ACACTTGCAACTGAACTTTCGAAA
GAAGTCGGCCTTATTCCCTCGTTC -> AAGTCGGCCTTATTCCCTCGTTCA
TATTCTGTCAACCGGGATGTACGC -> ATTCTGTCAACCGGGATGTACGCT
GTAAAAACGCAATTAGGCGGGAGC -> TAAAAACGCAATTAGGCGGGAGCG
GTAACTTCAAGCCGTGTGACTTCG -> TAACTTCAAGCCGTGTGACTTCGT
GAATTTTGTCGATCAGGGTGTAGT -> AATTTTGTCGATCAGGGTGTAGTC
CCAATTCCGTTTAAGTCGCCAAGA -> CAATTCCGTTTAAGTCGCCAAGAT
AAGCTTCCAAGTGACATGACCTTG -> AGCTTCCAAGTGACATGACCTTGA
AGAAGATTGTATGCGGCCCCATTC -> GAAGATTGTATGCGGCCCCATTCC
CCTATCCGAAACGACATGACTCCA -> CTATCCGAAACGACATGACTCCAA
CCTCCCGGACTGTAGTAACTCCTG -> CTCCCGGACTGTAGTAACTCCTGG
CGCCTCATCTTTCCGGGCGAGTCC -> GCCTCATCTTTCCGGGCGAGTCCG
CGGCTCCTGACGCTAACTTACTAA -> GGCTCCTGACGCTAACTTACTAAG
CTGACGCTAACTTACTAAGCCGGT -> TGACGCTAACTTACTAAGCCGGTA
GCCAAGATCTATACCCTTGTCTGG -> CCAAGATCTATACCCTTGTCTGGG
TTATCCTCTTAGTGATTGTATTTC -> TATCCTCTTAGTGATTGTATTTCT
CAAGTCTAGGGAATTATCGTCACT -> AAGTCTAGGGAATTATCGTCACTA
CTAACCCCCCAATATACTTAGGCG -> TAACCCCCCAATATACTTAGGCGT
CCTTTAGACTCCCGACAGCCCGTA -> CTTTAGACTCCCGACAGCCCGTAA
CTTTCGAATTTTCAAGGGTCTTCA -> TTTCGAATTTTCAAGGGTCTTCAT
ATCAGAGCATCCCTAAGCTTCCAA -> TCAGAGCATCCCTAAGCTTCCAAG
TAAACGGTGAAGCTTACAGCCATT -> AAACGGTGAAGCTTACAGCCATTG
CAACGTCCCAACTAGAGACCGCCG -> AACGTCCCAACTAGAGACCGCCGT
TTTTTAGCACACATGTATTCTGTC -> TTTTAGCACACATGTATTCTGTCA
TCGAACACGACCGCTCATGGTACG -> CGAACACGACCGCTCATGGTACGA
TTCCGTTTAAGTCGCCAAGATCTA -> TCCGTTTAAGTCGCCAAGATCTAT
CTAACTTACTAAGCCGGTACGTCC -> TAACTTACTAAGCCGGTACGTCCA
ATCAGGTGCTTTTTTAGCACACAT -> TCAGGTGCTTTTTTAGCACACATG
GCTTAGCAGGCCACATGCTGCATC -> CTTAGCAGGCCACATGCTGCATCC
CCCGATAGGACGGCGATCAGTACT -> CCGATAGGACGGCGATCAGTACTG
GATGTACGCTGGCGGCTCCTGACG -> ATGTACGCTGGCGGCTCCTGACGC
GGGTTGAATATAATGCCACAACAG -> GGTTGAATATAATGCCACAACAGA
GCGATAGTAGATGAGTGCAATATG -> CGATAGTAGATGAGTGCAATATGA
GCTGCATCCTGATGTGTCATACCA -> CTGCATCCTGATGTGTCATACCAA
CCGATTGTGAGGATAAACCCTACA -> CGATTGTGAGGATAAACCCTACAG
GACCCGTGCTTAGAGCAGTAAAAA -> ACCCGTGCTTAGAGCAGTAAAAAC
AAACCCTACAGCACAACGTCCCAA -> AACCCTACAGCACAACGTCCCAAC
AAATTCCTAATCCCAAGCCATACT -> AATTCCTAATCCCAAGCCATACTC
GGGACCACTATGAACCATTTCAAA -> GGACCACTATGAACCATTTCAAAG
CTGGTCGCTCCGTACAAGCCCATT -> TGGTCGCTCCGTACAAGCCCATTG
AGTCCGCCGGCGACTGATAACACT -> GTCCGCCGGCGACTGATAACACTT
TCGAATTTTCAAGGGTCTTCATAA -> CGAATTTTCAAGGGTCTTCATAAG
AGCACAACGTCCCAACTAGAGACC -> GCACAACGTCCCAACTAGAGACCG
CTGCTCGCCAACTCGCCAATTCCG -> TGCTCGCCAACTCGCCAATTCCGT
TCGTCTGGTCGACAAATCTCCGTA -> CGTCTGGTCGACAAATCTCCGTAA
TTACGAGCAGCTCTACGTGGCCGT -> TACGAGCAGCTCTACGTGGCCGTG
ACGCCGATTGTGAGGATAAACCCT -> CGCCGATTGTGAGGATAAACCCTA
CGTGGCCGTGTTCACATGGATGTT -> GTGGCCGTGTTCACATGGATGTTA
CGCTCCGGAACGGGTCTACGGCCA -> GCTCCGGAACGGGTCTACGGCCAC
AAGTCGCCAAGATCTATACCCTTG -> AGTCGCCAAGATCTATACCCTTGT
ATCCCTAAGCTTCCAAGTGACATG -> TCCCTAAGCTTCCAAGTGACATGA
CTACATTTACAGCCGGGTTGAATA -> TACATTTACAGCCGGGTTGAATAT
GTCGGCAGGGTGCTGTTAAAGCTG -> TCGGCAGGGTGCTGTTAAAGCTGG
CACGTCCATGAGAACGCCTCATCT -> ACGTCCATGAGAACGCCTCATCTT
TCCCCCCCCTTTCGAATTTTCAAG -> CCCCCCCCTTTCGAATTTTCAAGG
TTCAAGGGTCTTCATAAGTGTCTA -> TCAAGGGTCTTCATAAGTGTCTAT
CTCGCCAATTCCGTTTAAGTCGCC -> TCGCCAATTCCGTTTAAGTCGCCA
CTAGACCCGTGCTTAGAGCAGTAA -> TAGACCCGTGCTTAGAGCAGTAAA
TTGTTGTAACTGAAATGAAATTCC -> TGTTGTAACTGAAATGAAATTCCT
CTTCATAAGTGTCTATACAGGATT -> TTCATAAGTGTCTATACAGGATTG
TTGGAGATGCCGTCGCTCCGGAAC -> TGGAGATGCCGTCGCTCCGGAACG
CTTATAGTGTCTTCACGTCCATGA -> TTATAGTGTCTTCACGTCCATGAG
ACGTGGCCGTGTTCACATGGATGT -> CGTGGCCGTGTTCACATGGATGTT
ACAGCTTTTCGTAACATTTCTCCG -> CAGCTTTTCGTAACATTTCTCCGA
CTACGTGGCCGTGTTCACATGGAT -> TACGTGGCCGTGTTCACATGGATG
TCATGCTGGGGTCGGGCCTGCTCG -> CATGCTGGGGTCGGGCCTGCTCGC
GTCAGCAACACTTGGAAGTGCGAT -> TCAGCAACACTTGGAAGTGCGATA
TTACAGACTGTTTAAGGTTACTAC -> TACAGACTGTTTAAGGTTACTACC
CGAAGCAGCGGTCTGTCAGTGGTG -> GAAGCAGCGGTCTGTCAGTGGTGT
CGGCACGTGGTGGGACCACTATGA -> GGCACGTGGTGGGACCACTATGAA
GGCCTATCCGAAACGACATGACTC -> GCCTATCCGAAACGACATGACTCC
GAACATTGGAAGACCTCGCAAATG -> AACATTGGAAGACCTCGCAAATGA
TTAGAGCACAGAAGAATTCTCGAA -> TAGAGCACAGAAGAATTCTCGAAG
CGTTTGTTGTAACTGAAATGAAAT -> GTTTGTTGTAACTGAAATGAAATT
AGTCTGAATTTAGGGGGTTACAAA -> GTCTGAATTTAGGGGGTTACAAAC
GTGTTCACATGGATGTTACTAGAC -> TGTTCACATGGATGTTACTAGACG
TTATTCCCTCGTTCAACACAGATA -> TATTCCCTCGTTCAACACAGATAA
GAAGTCTGAATTTAGGGGGTTACA -> AAGTCTGAATTTAGGGGGTTACAA
GTGATGTGTCCTGTGTCAGCAACA -> TGATGTGTCCTGTGTCAGCAACAC
CACAACAGAAGTCGGCATGCCTGG -> ACAACAGAAGTCGGCATGCCTGGC
CAGCAACACTTGGAAGTGCGATAC -> AGCAACACTTGGAAGTGCGATACC
CAGCCCGTAAAAGCATCTTCACGT -> AGCCCGTAAAAGCATCTTCACGTA
AACCTAGACCCGTGCTTAGAGCAG -> ACCTAGACCCGTGCTTAGAGCAGT
GTTACTACCGCGACAGCTTTTCGT -> TTACTACCGCGACAGCTTTTCGTA
TAACTAGAGTCCATAAACATGTTC -> AACTAGAGTCCATAAACATGTTCT
GCCACAACAGAAGTCGGCATGCCT -> CCACAACAGAAGTCGGCATGCCTG
TCGTTACGGAACCGGAACGTAGAA -> CGTTACGGAACCGGAACGTAGAAG
CCGTAAAAGCATCTTCACGTATCT -> CGTAAAAGCATCTTCACGTATCTG
TAACTCCTGGTCGCTCCGTACAAG -> AACTCCTGGTCGCTCCGTACAAGC
GCTTACAGCCATTGACGCCATACG -> CTTACAGCCATTGACGCCATACGT
ATACCCCAAGGCTGGCGCGATAGT -> TACCCCAAGGCTGGCGCGATAGTA
CAGCCGGCCTTTGGAAACTGCTCG -> AGCCGGCCTTTGGAAACTGCTCGT
AGCTTACCCTATCTACATTTACAG -> GCTTACCCTATCTACATTTACAGC
GGGAGCGCCACAGTTGAATTGATA -> GGAGCGCCACAGTTGAATTGATAA
GCGATCCAACCTAGACCCGTGCTT -> CGATCCAACCTAGACCCGTGCTTA
GTTACGGAACCGGAACGTAGAAGG -> TTACGGAACCGGAACGTAGAAGGT
CCACGATAATCCAGTCATGCTGGG -> CACGATAATCCAGTCATGCTGGGG
GGACGTTTGTTGTAACTGAAATGA -> GACGTTTGTTGTAACTGAAATGAA
TTCTCCCCCCCCTTTCGAATTTTC -> TCTCCCCCCCCTTTCGAATTTTCA
TCCTGGTCGCTCCGTACAAGCCCA -> CCTGGTCGCTCCGTACAAGCCCAT
GGCCACTATACGCCCGGTAGAAGT -> GCCACTATACGCCCGGTAGAAGTC
GAGCACAGAAGAATTCTCGAAGCA -> AGCACAGAAGAATTCTCGAAGCAG
GATAGGACGGCGATCAGTACTGAA -> ATAGGACGGCGATCAGTACTGAAG
CTCCTCACCCGATAGGACGGCGAT -> TCCTCACCCGATAGGACGGCGATC
CGCCGTCAAACCGATATATATTCG -> GCCGTCAAACCGATATATATTCGC
ACTACCGCGACAGCTTTTCGTAAC -> CTACCGCGACAGCTTTTCGTAACA
CATTGACGCCATACGTCCGTGCTT -> ATTGACGCCATACGTCCGTGCTTC
ACTTGAACCTCTTAACGGTTCAAG -> CTTGAACCTCTTAACGGTTCAAGA
CGGCATGCCTGGCTTAGGGTTTCA -> GGCATGCCTGGCTTAGGGTTTCAC
TGAATATAATGCCACAACAGAAGT -> GAATATAATGCCACAACAGAAGTC
AATCCCAAGCCATACTCCGCTTCT -> ATCCCAAGCCATACTCCGCTTCTC
TGTGCTTGACCACCTTAGCATAAG -> GTGCTTGACCACCTTAGCATAAGT
AATACGGACGTTTGTTGTAACTGA -> ATACGGACGTTTGTTGTAACTGAA
CTCGAAGCAGCGGTCTGTCAGTGG -> TCGAAGCAGCGGTCTGTCAGTGGT
TAAGAGATCCGGATTGTGAGGGCG -> AAGAGATCCGGATTGTGAGGGCGT
GCCGGTTTGAACGCCGAAAGTCCG -> CCGGTTTGAACGCCGAAAGTCCGC
ACTTGTTACGAGCAGCTCTACGTG -> CTTGTTACGAGCAGCTCTACGTGG
ATTTAGGGGGTTACAAACTTGAAC -> TTTAGGGGGTTACAAACTTGAACC
CCATACTCCGCTTCTCCCCCCCCT -> CATACTCCGCTTCTCCCCCCCCTT
CCCCCCCCTTTCGAATTTTCAAGG -> CCCCCCCTTTCGAATTTTCAAGGG
CCCTGTGCATCAGTGAATTTTGTC -> CCTGTGCATCAGTGAATTTTGTCG
GTCATTAAAAGCGCTGCCCTGTAA -> TCATTAAAAGCGCTGCCCTGTAAA
TCAGGTGCTTTTTTAGCACACATG -> CAGGTGCTTTTTTAGCACACATGT
TTACGGAACCGGAACGTAGAAGGT -> TACGGAACCGGAACGTAGAAGGTA
ATCAGTGAATTTTGTCGATCAGGG -> TCAGTGAATTTTGTCGATCAGGGT
CCGTGGTACAACCTCCCGGACTGT -> CGTGGTACAACCTCCCGGACTGTA
TGCTTCGCCCGTTCTTCTGTGGTA -> GCTTCGCCCGTTCTTCTGTGGTAA
ATGTGTCATACCAATAGAAAAATC -> TGTGTCATACCAATAGAAAAATCA
CTCGTTACGGAACCGGAACGTAGA -> TCGTTACGGAACCGGAACGTAGAA
ATTACAATACTCCCTCAAGTCTAG -> TTACAATACTCCCTCAAGTCTAGG
AGTCGGCAGGGTGCTGTTAAAGCT -> GTCGGCAGGGTGCTGTTAAAGCTG
GTATTTCTAGTTCCCTGTGCATCA -> TATTTCTAGTTCCCTGTGCATCAG
TCTCTTGGACACTTGTTACGAGCA -> CTCTTGGACACTTGTTACGAGCAG
GACATGACTCCAATCAGGTGCTTT -> ACATGACTCCAATCAGGTGCTTTT
CAAGATCTATACCCTTGTCTGGGA -> AAGATCTATACCCTTGTCTGGGAC
ACACAGATAATTCTCTTGGACACT -> CACAGATAATTCTCTTGGACACTT
CTTTGGAAACTGCTCGTTCTCTGC -> TTTGGAAACTGCTCGTTCTCTGCT
GCTAAAGACTTATAGTGTCTTCAC -> CTAAAGACTTATAGTGTCTTCACG
AGTCGGCCTTATTCCCTCGTTCAA -> GTCGGCCTTATTCCCTCGTTCAAC
TATCTCGTTACGGAACCGGAACGT -> ATCTCGTTACGGAACCGGAACGTA
GGGTCGGGCCTGCTCGCCAACTCG -> GGTCGGGCCTGCTCGCCAACTCGC
AAACGCAATTAGGCGGGAGCGCCA -> AACGCAATTAGGCGGGAGCGCCAC
GAAATTCCTAATCCCAAGCCATAC -> AAATTCCTAATCCCAAGCCATACT
AGGCCTATCCGAAACGACATGACT -> GGCCTATCCGAAACGACATGACTC
GGTAGAAGTCTGAATTTAGGGGGT -> GTAGAAGTCTGAATTTAGGGGGTT
TAATTCTCTTGGACACTTGTTACG -> AATTCTCTTGGACACTTGTTACGA
TTAGGCGGGAGCGCCACAGTTGAA -> TAGGCGGGAGCGCCACAGTTGAAT
TAAGAGAGCTTACCCTATCTACAT -> AAGAGAGCTTACCCTATCTACATT
CTAATCCCAAGCCATACTCCGCTT -> TAATCCCAAGCCATACTCCGCTTC
TCCAGTCATGCTGGGGTCGGGCCT -> CCAGTCATGCTGGGGTCGGGCCTG
GTAACTCCTGGTCGCTCCGTACAA -> TAACTCCTGGTCGCTCCGTACAAG
TGAGTGCAATATGAAGTCGGCAGG -> GAGTGCAATATGAAGTCGGCAGGG
CCCTATGCACCCGTGGTACAACCT -> CCTATGCACCCGTGGTACAACCTC
TTTTTTAGCACACATGTATTCTGT -> TTTTTAGCACACATGTATTCTGTC
TCGTCACTAGTGATGTGTCCTGTG -> CGTCACTAGTGATGTGTCCTGTGT
ACAGGATTGCGGTGTGCTTGACCA -> CAGGATTGCGGTGTGCTTGACCAC
CATGTTCTTCGTTATTACAATACT -> ATGTTCTTCGTTATTACAATACTC
GTCCGCCGGCGACTGATAACACTT -> TCCGCCGGCGACTGATAACACTTG
CAGTAAAAACGCAATTAGGCGGGA -> AGTAAAAACGCAATTAGGCGGGAG
CACACATGTATTCTGTCAACCGGG -> ACACATGTATTCTGTCAACCGGGA
GGGCGAGTCCGGCATGTTAGAGCA -> GGCGAGTCCGGCATGTTAGAGCAC
CAATATACTTAGGCGTAAGAGAGC -> AATATACTTAGGCGTAAGAGAGCT
CCTAATCCCAAGCCATACTCCGCT -> CTAATCCCAAGCCATACTCCGCTT
AGACTCCCGACAGCCCGTAAAAGC -> GACTCCCGACAGCCCGTAAAAGCA
TGGAAGTGCGATACCGTGGCCGGT -> GGAAGTGCGATACCGTGGCCGGTC
ATAGTGTCTTCACGTCCATGAGAA -> TAGTGTCTTCACGTCCATGAGAAC
GTCAGTGGTGTGCTCGAATAGCAT -> TCAGTGGTGTGCTCGAATAGCATA
GGTCGCTCCGTACAAGCCCATTGG -> GTCGCTCCGTACAAGCCCATTGGA
CGCTCAGCCAGAAGATTGTATGCG -> GCTCAGCCAGAAGATTGTATGCGG
GCAATATGAAGTCGGCAGGGTGCT -> CAATATGAAGTCGGCAGGGTGCTG
TATCCTCTTAGTGATTGTATTTCT -> ATCCTCTTAGTGATTGTATTTCTA
AAAAGCATCTTCACGTATCTGTAG -> AAAGCATCTTCACGTATCTGTAGA
GCCTATCCGAAACGACATGACTCC -> CCTATCCGAAACGACATGACTCCA
ACACTTGTTACGAGCAGCTCTACG -> CACTTGTTACGAGCAGCTCTACGT
GAGATGCCGTCGCTCCGGAACGGG -> AGATGCCGTCGCTCCGGAACGGGT
CGTTCAACACAGATAATTCTCTTG -> GTTCAACACAGATAATTCTCTTGG
GCCTCTACAGCCGGCCTTTGGAAA -> CCTCTACAGCCGGCCTTTGGAAAC
AGGTGCTTTTTTAGCACACATGTA -> GGTGCTTTTTTAGCACACATGTAT
AGGGTTTCACTATCTCGTTACGGA -> GGGTTTCACTATCTCGTTACGGAA
TAAACATGTTCTTCGTTATTACAA -> AAACATGTTCTTCGTTATTACAAT
GAGTCCATAAACATGTTCTTCGTT -> AGTCCATAAACATGTTCTTCGTTA
CATCTTTCCGGGCGAGTCCGGCAT -> ATCTTTCCGGGCGAGTCCGGCATG
AGACCTCGCAAATGAATATAGAGA -> GACCTCGCAAATGAATATAGAGAT
GCCAGAAGATTGTATGCGGCCCCA -> CCAGAAGATTGTATGCGGCCCCAT
AATATGAAGTCGGCAGGGTGCTGT -> ATATGAAGTCGGCAGGGTGCTGTT
TTAGCAGGCCACATGCTGCATCCT -> TAGCAGGCCACATGCTGCATCCTG
AACCTTGCTTTATCCTCTTAGTGA -> ACCTTGCTTTATCCTCTTAGTGAT
GACTCCCGACAGCCCGTAAAAGCA -> ACTCCCGACAGCCCGTAAAAGCAT
AGCAACACTTGGAAGTGCGATACC -> GCAACACTTGGAAGTGCGATACCG
CCCTTGTCTGGGACGAAGTCGGCC -> CCTTGTCTGGGACGAAGTCGGCCT
CATGGATGTTACTAGACGCGAATG -> ATGGATGTTACTAGACGCGAATGT
TGGTGGGACCACTATGAACCATTT -> GGTGGGACCACTATGAACCATTTC
TTAAGGTTACTACCGCGACAGCTT -> TAAGGTTACTACCGCGACAGCTTT
TGTGCATCAGTGAATTTTGTCGAT -> GTGCATCAGTGAATTTTGTCGATC
TACGGCCACGATAATCCAGTCATG -> ACGGCCACGATAATCCAGTCATGC
AGAAGTCTGAATTTAGGGGGTTAC -> GAAGTCTGAATTTAGGGGGTTACA
CCGGGATGTACGCTGGCGGCTCCT -> CGGGATGTACGCTGGCGGCTCCTG
TACGACCGAGCGCATGGCACCTTT -> ACGACCGAGCGCATGGCACCTTTA
CGCCACAGTTGAATTGATAAACGG -> GCCACAGTTGAATTGATAAACGGT
TCGCCTCCTCACCCGATAGGACGG -> CGCCTCCTCACCCGATAGGACGGC
CGCTTCACCCTATGCACCCGTGGT -> GCTTCACCCTATGCACCCGTGGTA
TAGAGCAGTAAAAACGCAATTAGG -> AGAGCAGTAAAAACGCAATTAGGC
CTCGCAAATGAATATAGAGATGAG -> TCGCAAATGAATATAGAGATGAGG
GAGCAGTAAAAACGCAATTAGGCG -> AGCAGTAAAAACGCAATTAGGCGG
GGGCCTGCTCGCCAACTCGCCAAT -> GGCCTGCTCGCCAACTCGCCAATT
GCACAACGTCCCAACTAGAGACCG -> CACAACGTCCCAACTAGAGACCGC
AGATGAGTGCAATATGAAGTCGGC -> GATGAGTGCAATATGAAGTCGGCA
CTGGCTTAGGGTTTCACTATCTCG -> TGGCTTAGGGTTTCACTATCTCGT
GAGGATAAACCCTACAGCACAACG -> AGGATAAACCCTACAGCACAACGT
CACTATGAACCATTTCAAAGGCCA -> ACTATGAACCATTTCAAAGGCCAC
GCAGGCCACATGCTGCATCCTGAT -> CAGGCCACATGCTGCATCCTGATG
GATGAGGATCGGCACGTGGTGGGA -> ATGAGGATCGGCACGTGGTGGGAC
CTACAGCACAACGTCCCAACTAGA -> TACAGCACAACGTCCCAACTAGAG
CAGCTTTTCGTAACATTTCTCCGA -> AGCTTTTCGTAACATTTCTCCGAC
CATTGGAGATGCCGTCGCTCCGGA -> ATTGGAGATGCCGTCGCTCCGGAA
CCGCCGTCAAACCGATATATATTC -> CGCCGTCAAACCGATATATATTCG
TCCAAGTGACATGACCTTGAGGTC -> CCAAGTGACATGACCTTGAGGTCG
GTTTCACTATCTCGTTACGGAACC -> TTTCACTATCTCGTTACGGAACCG
GCCATACTCCGCTTCTCCCCCCCC -> CCATACTCCGCTTCTCCCCCCCCT
TTCAAAGGCCACTATACGCCCGGT -> TCAAAGGCCACTATACGCCCGGTA
TAGAAAAATCAGAGCATCCCTAAG -> AGAAAAATCAGAGCATCCCTAAGC
AGAGCTTACCCTATCTACATTTAC -> GAGCTTACCCTATCTACATTTACA
ACACTTGGAAGTGCGATACCGTGG -> CACTTGGAAGTGCGATACCGTGGC
CTCAGCCAGAAGATTGTATGCGGC -> TCAGCCAGAAGATTGTATGCGGCC
CGGACTGTAGTAACTCCTGGTCGC -> GGACTGTAGTAACTCCTGGTCGCT
AGACCGCCGTCAAACCGATATATA -> GACCGCCGTCAAACCGATATATAT
CACTTGTTACGAGCAGCTCTACGT -> ACTTGTTACGAGCAGCTCTACGTG
TGCATCCTGATGTGTCATACCAAT -> GCATCCTGATGTGTCATACCAATA
CGACAGCCCGTAAAAGCATCTTCA -> GACAGCCCGTAAAAGCATCTTCAC
AAATGAATATAGAGATGAGGATCG -> AATGAATATAGAGATGAGGATCGG
CGACCGCTCATGGTACGACCGAGC -> GACCGCTCATGGTACGACCGAGCG
GAACGCCTCATCTTTCCGGGCGAG -> AACGCCTCATCTTTCCGGGCGAGT
TGGCGCGATAGTAGATGAGTGCAA -> GGCGCGATAGTAGATGAGTGCAAT
CGTTTAAGTCGCCAAGATCTATAC -> GTTTAAGTCGCCAAGATCTATACC
ACCCTATGCACCCGTGGTACAACC -> CCCTATGCACCCGTGGTACAACCT
GTGTCTATACAGGATTGCGGTGTG -> TGTCTATACAGGATTGCGGTGTGC
ATTCCGTTTAAGTCGCCAAGATCT -> TTCCGTTTAAGTCGCCAAGATCTA
GGCGTAAGAGAGCTTACCCTATCT -> GCGTAAGAGAGCTTACCCTATCTA
AACGCAATTAGGCGGGAGCGCCAC -> ACGCAATTAGGCGGGAGCGCCACA
CTGGTCGAGTGAAGGCCTATCCGA -> TGGTCGAGTGAAGGCCTATCCGAA
ACGGCCACGATAATCCAGTCATGC -> CGGCCACGATAATCCAGTCATGCT
GAATTTTCAAGGGTCTTCATAAGT -> AATTTTCAAGGGTCTTCATAAGTG
GCTTTATCCTCTTAGTGATTGTAT -> CTTTATCCTCTTAGTGATTGTATT
CGATATATATTCGCTCAGCCAGAA -> GATATATATTCGCTCAGCCAGAAG
GTCGATCAGGGTGTAGTCGCCTCC -> TCGATCAGGGTGTAGTCGCCTCCT
GTCGGGCCTGCTCGCCAACTCGCC -> TCGGGCCTGCTCGCCAACTCGCCA
CAACTGAACTTTCGAAAGCGATCC -> AACTGAACTTTCGAAAGCGATCCA
ACCTTTAGACTCCCGACAGCCCGT -> CCTTTAGACTCCCGACAGCCCGTA
CTAAGCTTCCAAGTGACATGACCT -> TAAGCTTCCAAGTGACATGACCTT
TTGTCGATCAGGGTGTAGTCGCCT -> TGTCGATCAGGGTGTAGTCGCCTC
GCTCGCCAACTCGCCAATTCCGTT -> CTCGCCAACTCGCCAATTCCGTTT
CCCTATCTACATTTACAGCCGGGT -> CCTATCTACATTTACAGCCGGGTT
ACGGACGTTTGTTGTAACTGAAAT -> CGGACGTTTGTTGTAACTGAAATG
ACCTAGACCCGTGCTTAGAGCAGT -> CCTAGACCCGTGCTTAGAGCAGTA
TCAACCGGGATGTACGCTGGCGGC -> CAACCGGGATGTACGCTGGCGGCT
CCAATCAGGTGCTTTTTTAGCACA -> CAATCAGGTGCTTTTTTAGCACAC
TTGACCACCTTAGCATAAGTACGC -> TGACCACCTTAGCATAAGTACGCT
CATGGTACGACCGAGCGCATGGCA -> ATGGTACGACCGAGCGCATGGCAC
AAGTCTGAATTTAGGGGGTTACAA -> AGTCTGAATTTAGGGGGTTACAAA
ATATATATTCGCTCAGCCAGAAGA -> TATATATTCGCTCAGCCAGAAGAT
AAGTCGGCAGGGTGCTGTTAAAGC -> AGTCGGCAGGGTGCTGTTAAAGCT
CCTGTGTCAGCAACACTTGGAAGT -> CTGTGTCAGCAACACTTGGAAGTG
TCGTTTGCGCCCTTGGTGCCTCTA -> CGTTTGCGCCCTTGGTGCCTCTAC
TTGTAACTGAAATGAAATTCCTAA -> TGTAACTGAAATGAAATTCCTAAT
GCCGAAAGTCCGCCGGCGACTGAT -> CCGAAAGTCCGCCGGCGACTGATA
TACGCCCGGTAGAAGTCTGAATTT -> ACGCCCGGTAGAAGTCTGAATTTA
AACGTAGAAGGTAATACCCCAAGG -> ACGTAGAAGGTAATACCCCAAGGC
ACCTTAGCATAAGTACGCTTCACC -> CCTTAGCATAAGTACGCTTCACCC
CTAGAGTCCATAAACATGTTCTTC -> TAGAGTCCATAAACATGTTCTTCG
TCAAGGGTCTTCATAAGTGTCTAT -> CAAGGGTCTTCATAAGTGTCTATA
GTACAACCTCCCGGACTGTAGTAA -> TACAACCTCCCGGACTGTAGTAAC
GCGTAAGAGAGCTTACCCTATCTA -> CGTAAGAGAGCTTACCCTATCTAC
CAACTAGAGACCGCCGTCAAACCG -> AACTAGAGACCGCCGTCAAACCGA
ATCAGGGTGTAGTCGCCTCCTCAC -> TCAGGGTGTAGTCGCCTCCTCACC
CCCTCGTTCAACACAGATAATTCT -> CCTCGTTCAACACAGATAATTCTC
GAATATAATGCCACAACAGAAGTC -> AATATAATGCCACAACAGAAGTCG
ACCACTATGAACCATTTCAAAGGC -> CCACTATGAACCATTTCAAAGGCC
AAGTGTCTATACAGGATTGCGGTG -> AGTGTCTATACAGGATTGCGGTGT
CAGTTGAATTGATAAACGGTGAAG -> AGTTGAATTGATAAACGGTGAAGC
TTTCCGGGCGAGTCCGGCATGTTA -> TTCCGGGCGAGTCCGGCATGTTAG
GGATTGCGGTGTGCTTGACCACCT -> GATTGCGGTGTGCTTGACCACCTT
GACGCCGATTGTGAGGATAAACCC -> ACGCCGATTGTGAGGATAAACCCT
ATCCAACCTAGACCCGTGCTTAGA -> TCCAACCTAGACCCGTGCTTAGAG
CTTTAAATGTTAGCCGGTTTGAAC -> TTTAAATGTTAGCCGGTTTGAACG
TTTGTCGATCAGGGTGTAGTCGCC -> TTGTCGATCAGGGTGTAGTCGCCT
ACGCCGAAAGTCCGCCGGCGACTG -> CGCCGAAAGTCCGCCGGCGACTGA
TTAGAGCAGTAAAAACGCAATTAG -> TAGAGCAGTAAAAACGCAATTAGG
CCGTGTTCACATGGATGTTACTAG -> CGTGTTCACATGGATGTTACTAGA
TTAAAAGCGCTGCCCTGTAAAGTA -> TAAAAGCGCTGCCCTGTAAAGTAA
GCCGTGTGACTTCGTTCCCCCACA -> CCGTGTGACTTCGTTCCCCCACAT
GTTTGTTGTAACTGAAATGAAATT -> TTTGTTGTAACTGAAATGAAATTC
GATACCGTGGCCGGTCATTAAAAG -> ATACCGTGGCCGGTCATTAAAAGC
GGGTGCTGTTAAAGCTGGTCGAGT -> GGTGCTGTTAAAGCTGGTCGAGTG
TCGCTCCGGAACGGGTCTACGGCC -> CGCTCCGGAACGGGTCTACGGCCA
CTTTCCGGGCGAGTCCGGCATGTT -> TTTCCGGGCGAGTCCGGCATGTTA
GAAGCTTACAGCCATTGACGCCAT -> AAGCTTACAGCCATTGACGCCATA
TGCATCAGTGAATTTTGTCGATCA -> GCATCAGTGAATTTTGTCGATCAG
GAACCGGAACGTAGAAGGTAATAC -> AACCGGAACGTAGAAGGTAATACC
TCAGGGTGTAGTCGCCTCCTCACC -> CAGGGTGTAGTCGCCTCCTCACCC
GCGCTGCCCTGTAAAGTAAGAGAT -> CGCTGCCCTGTAAAGTAAGAGATC
TATCTACATTTACAGCCGGGTTGA -> ATCTACATTTACAGCCGGGTTGAA
ATGCTGCATCCTGATGTGTCATAC -> TGCTGCATCCTGATGTGTCATACC
TTACTAGACGCGAATGTCGTTTGC -> TACTAGACGCGAATGTCGTTTGCG
GAGAACGCCTCATCTTTCCGGGCG -> AGAACGCCTCATCTTTCCGGGCGA
GAATTCTCGAAGCAGCGGTCTGTC -> AATTCTCGAAGCAGCGGTCTGTCA
AGATGAGGATCGGCACGTGGTGGG -> GATGAGGATCGGCACGTGGTGGGA
TATGAACCATTTCAAAGGCCACTA -> ATGAACCATTTCAAAGGCCACTAT
TCAGTGGTGTGCTCGAATAGCATA -> CAGTGGTGTGCTCGAATAGCATAA
ACGGTGAAGCTTACAGCCATTGAC -> CGGTGAAGCTTACAGCCATTGACG
CACCCTATGCACCCGTGGTACAAC -> ACCCTATGCACCCGTGGTACAACC
CGGGATGTACGCTGGCGGCTCCTG -> GGGATGTACGCTGGCGGCTCCTGA
TGTTAGAGCACAGAAGAATTCTCG -> GTTAGAGCACAGAAGAATTCTCGA
GGCCTTTGGAAACTGCTCGTTCTC -> GCCTTTGGAAACTGCTCGTTCTCT
GGACACTTGTTACGAGCAGCTCTA -> GACACTTGTTACGAGCAGCTCTAC
CCCGACAGCCCGTAAAAGCATCTT -> CCGACAGCCCGTAAAAGCATCTTC
GCAAGCTTAGCAGGCCACATGCTG -> CAAGCTTAGCAGGCCACATGCTGC
GTAGAACATTGGAAGACCTCGCAA -> TAGAACATTGGAAGACCTCGCAAA
GAAGTCGGCAGGGTGCTGTTAAAG -> AAGTCGGCAGGGTGCTGTTAAAGC
CAGTCATGCTGGGGTCGGGCCTGC -> AGTCATGCTGGGGTCGGGCCTGCT
ATGGCACCTTTAGACTCCCGACAG -> TGGCACCTTTAGACTCCCGACAGC
CATTGGAAGACCTCGCAAATGAAT -> ATTGGAAGACCTCGCAAATGAATA
GTAGAAGGTAATACCCCAAGGCTG -> TAGAAGGTAATACCCCAAGGCTGG
TGGGACGAAGTCGGCCTTATTCCC -> GGGACGAAGTCGGCCTTATTCCCT
ACATGTTCTTCGTTATTACAATAC -> CATGTTCTTCGTTATTACAATACT
ATGTTAGCCGGTTTGAACGCCGAA -> TGTTAGCCGGTTTGAACGCCGAAA
AATACCCCAAGGCTGGCGCGATAG -> ATACCCCAAGGCTGGCGCGATAGT
TTCACGTCCATGAGAACGCCTCAT -> TCACGTCCATGAGAACGCCTCATC
CATAAATTCGAACACGACCGCTCA -> ATAAATTCGAACACGACCGCTCAT
TTTTGTCGATCAGGGTGTAGTCGC -> TTTGTCGATCAGGGTGTAGTCGCC
TTTCTAGTTCCCTGTGCATCAGTG -> TTCTAGTTCCCTGTGCATCAGTGA
TCCTGTGTCAGCAACACTTGGAAG -> CCTGTGTCAGCAACACTTGGAAGT
TTACAGCCGGGTTGAATATAATGC -> TACAGCCGGGTTGAATATAATGCC
TTCAAGCCGTGTGACTTCGTTCCC -> TCAAGCCGTGTGACTTCGTTCCCC
GCAACACTTGGAAGTGCGATACCG -> CAACACTTGGAAGTGCGATACCGT
GTCGCTCCGGAACGGGTCTACGGC -> TCGCTCCGGAACGGGTCTACGGCC
CTCTTAGTGATTGTATTTCTAGTT -> TCTTAGTGATTGTATTTCTAGTTC
GGAAACTGCTCGTTCTCTGCTTTA -> GAAACTGCTCGTTCTCTGCTTTAA
CATTTACAGCCGGGTTGAATATAA -> ATTTACAGCCGGGTTGAATATAAT
CTCCGTACAAGCCCATTGGAGATG -> TCCGTACAAGCCCATTGGAGATGC
CCATTGGAGATGCCGTCGCTCCGG -> CATTGGAGATGCCGTCGCTCCGGA
TCGGCCTTATTCCCTCGTTCAACA -> CGGCCTTATTCCCTCGTTCAACAC
AGAGATGAGGATCGGCACGTGGTG -> GAGATGAGGATCGGCACGTGGTGG
AACAGAAGTCGGCATGCCTGGCTT -> ACAGAAGTCGGCATGCCTGGCTTA
CAGATAATTCTCTTGGACACTTGT -> AGATAATTCTCTTGGACACTTGTT
GTCTTCACGTCCATGAGAACGCCT -> TCTTCACGTCCATGAGAACGCCTC
CACTATACGCCCGGTAGAAGTCTG -> ACTATACGCCCGGTAGAAGTCTGA
AATGCCACAACAGAAGTCGGCATG -> ATGCCACAACAGAAGTCGGCATGC
CGGATTGTGAGGGCGTCAATATCC -> GGATTGTGAGGGCGTCAATATCCT
GTTGTAACTGAAATGAAATTCCTA -> TTGTAACTGAAATGAAATTCCTAA
GGGGTTACAAACTTGAACCTCTTA -> GGGTTACAAACTTGAACCTCTTAA
CCACAGTTGAATTGATAAACGGTG -> CACAGTTGAATTGATAAACGGTGA
AATTCCGTTTAAGTCGCCAAGATC -> ATTCCGTTTAAGTCGCCAAGATCT
CTTACAGCCATTGACGCCATACGT -> TTACAGCCATTGACGCCATACGTC
GCCACATGCTGCATCCTGATGTGT -> CCACATGCTGCATCCTGATGTGTC
CATACCAATAGAAAAATCAGAGCA -> ATACCAATAGAAAAATCAGAGCAT
CTCCGGAACGGGTCTACGGCCACG -> TCCGGAACGGGTCTACGGCCACGA
GCTTTTTTAGCACACATGTATTCT -> CTTTTTTAGCACACATGTATTCTG
TTATAGTGTCTTCACGTCCATGAG -> TATAGTGTCTTCACGTCCATGAGA
CCACTATGAACCATTTCAAAGGCC -> CACTATGAACCATTTCAAAGGCCA
ACCGTGGCCGGTCATTAAAAGCGC -> CCGTGGCCGGTCATTAAAAGCGCT
GCTTGACCACCTTAGCATAAGTAC -> CTTGACCACCTTAGCATAAGTACG
AATGAATATAGAGATGAGGATCGG -> ATGAATATAGAGATGAGGATCGGC
TTGTATGCGGCCCCATTCCCATCA -> TGTATGCGGCCCCATTCCCATCAA
ATACTCCGCTTCTCCCCCCCCTTT -> TACTCCGCTTCTCCCCCCCCTTTC
GTCCAATACGGACGTTTGTTGTAA -> TCCAATACGGACGTTTGTTGTAAC
TCAAGAGCTAACCCCCCAATATAC -> CAAGAGCTAACCCCCCAATATACT
CCGTCAAACCGATATATATTCGCT -> CGTCAAACCGATATATATTCGCTC
CTCACCCGATAGGACGGCGATCAG -> TCACCCGATAGGACGGCGATCAGT
GCTTCCAAGTGACATGACCTTGAG -> CTTCCAAGTGACATGACCTTGAGG
ACAGCCCGTAAAAGCATCTTCACG -> CAGCCCGTAAAAGCATCTTCACGT
TTACCCTATCTACATTTACAGCCG -> TACCCTATCTACATTTACAGCCGG
AACACGACCGCTCATGGTACGACC -> ACACGACCGCTCATGGTACGACCG
TATACTTAGGCGTAAGAGAGCTTA -> ATACTTAGGCGTAAGAGAGCTTAC
TTACAATACTCCCTCAAGTCTAGG -> TACAATACTCCCTCAAGTCTAGGG
ATTCCCTCGTTCAACACAGATAAT -> TTCCCTCGTTCAACACAGATAATT
TAGGCGTAAGAGAGCTTACCCTAT -> AGGCGTAAGAGAGCTTACCCTATC
GTAAGAGATCCGGATTGTGAGGGC -> TAAGAGATCCGGATTGTGAGGGCG
GCATAAGTACGCTTCACCCTATGC -> CATAAGTACGCTTCACCCTATGCA
AAATTCGAACACGACCGCTCATGG -> AATTCGAACACGACCGCTCATGGT
GGCATGTTAGAGCACAGAAGAATT -> GCATGTTAGAGCACAGAAGAATTC
CGCCGATTGTGAGGATAAACCCTA -> GCCGATTGTGAGGATAAACCCTAC
TGCTCGAATAGCATAAATTCGAAC -> GCTCGAATAGCATAAATTCGAACA
TCTCGAAGCAGCGGTCTGTCAGTG -> CTCGAAGCAGCGGTCTGTCAGTGG
TCCGTGCTTCGCCCGTTCTTCTGT -> CCGTGCTTCGCCCGTTCTTCTGTG
TCCGAAACGACATGACTCCAATCA -> CCGAAACGACATGACTCCAATCAG
AAGCATCTTCACGTATCTGTAGAA -> AGCATCTTCACGTATCTGTAGAAC
CCAACTAGAGACCGCCGTCAAACC -> CAACTAGAGACCGCCGTCAAACCG
GTCAAACCGATATATATTCGCTCA -> TCAAACCGATATATATTCGCTCAG
TCACCCTATGCACCCGTGGTACAA -> CACCCTATGCACCCGTGGTACAAC
AACGGTGAAGCTTACAGCCATTGA -> ACGGTGAAGCTTACAGCCATTGAC
TTATTACAATACTCCCTCAAGTCT -> TATTACAATACTCCCTCAAGTCTA
TATCCGAAACGACATGACTCCAAT -> ATCCGAAACGACATGACTCCAATC
GACGCCATACGTCCGTGCTTCGCC -> ACGCCATACGTCCGTGCTTCGCCC
CAACACAGATAATTCTCTTGGACA -> AACACAGATAATTCTCTTGGACAC
ACGTAGAAGGTAATACCCCAAGGC -> CGTAGAAGGTAATACCCCAAGGCT
AACATGTTCTTCGTTATTACAATA -> ACATGTTCTTCGTTATTACAATAC
CTGGCGCGATAGTAGATGAGTGCA -> TGGCGCGATAGTAGATGAGTGCAA
CATGTTAGAGCACAGAAGAATTCT -> ATGTTAGAGCACAGAAGAATTCTC
CTCCAATCAGGTGCTTTTTTAGCA -> TCCAATCAGGTGCTTTTTTAGCAC
CTTGAACCTCTTAACGGTTCAAGA -> TTGAACCTCTTAACGGTTCAAGAG
CCGTGCTTCGCCCGTTCTTCTGTG -> CGTGCTTCGCCCGTTCTTCTGTGG
ACGTCCGTGCTTCGCCCGTTCTTC -> CGTCCGTGCTTCGCCCGTTCTTCT
AATGTCGTTTGCGCCCTTGGTGCC -> ATGTCGTTTGCGCCCTTGGTGCCT
CGTCTGGTCGACAAATCTCCGTAA -> GTCTGGTCGACAAATCTCCGTAAC
CTTTTTTAGCACACATGTATTCTG -> TTTTTTAGCACACATGTATTCTGT
CGCCCGGTAGAAGTCTGAATTTAG -> GCCCGGTAGAAGTCTGAATTTAGG
GCCCTTGGTGCCTCTACAGCCGGC -> CCCTTGGTGCCTCTACAGCCGGCC
GTTAGCCGGTTTGAACGCCGAAAG -> TTAGCCGGTTTGAACGCCGAAAGT
TTACTAAGCCGGTACGTCCAATAC -> TACTAAGCCGGTACGTCCAATACG
TTCGAAAGCGATCCAACCTAGACC -> TCGAAAGCGATCCAACCTAGACCC
GGGTTACAAACTTGAACCTCTTAA -> GGTTACAAACTTGAACCTCTTAAC
ATAGGACGGCGATCAGTACTGAAG -> TAGGACGGCGATCAGTACTGAAGA
TCCATAAACATGTTCTTCGTTATT -> CCATAAACATGTTCTTCGTTATTA
CAGAAGTCGGCATGCCTGGCTTAG -> AGAAGTCGGCATGCCTGGCTTAGG
TTTTAGCACACATGTATTCTGTCA -> TTTAGCACACATGTATTCTGTCAA
TTGAACCTCTTAACGGTTCAAGAG -> TGAACCTCTTAACGGTTCAAGAGC
GTGGTGGGACCACTATGAACCATT -> TGGTGGGACCACTATGAACCATTT
ATGTCGTTTGCGCCCTTGGTGCCT -> TGTCGTTTGCGCCCTTGGTGCCTC
CACAGTTGAATTGATAAACGGTGA -> ACAGTTGAATTGATAAACGGTGAA
TTTGTTGTAACTGAAATGAAATTC -> TTGTTGTAACTGAAATGAAATTCC
ATTGTGAGGATAAACCCTACAGCA -> TTGTGAGGATAAACCCTACAGCAC
GTTTAAGGTTACTACCGCGACAGC -> TTTAAGGTTACTACCGCGACAGCT
ACCGAGCGCATGGCACCTTTAGAC -> CCGAGCGCATGGCACCTTTAGACT
CCAGAAGATTGTATGCGGCCCCAT -> CAGAAGATTGTATGCGGCCCCATT
GTGCCTCTACAGCCGGCCTTTGGA -> TGCCTCTACAGCCGGCCTTTGGAA
GTCCTGTGTCAGCAACACTTGGAA -> TCCTGTGTCAGCAACACTTGGAAG
CTATACGCCCGGTAGAAGTCTGAA -> TATACGCCCGGTAGAAGTCTGAAT
TGACCTTGAGGTCGTCTGGTCGAC -> GACCTTGAGGTCGTCTGGTCGACA
CATGCTGCATCCTGATGTGTCATA -> ATGCTGCATCCTGATGTGTCATAC
CCTGGACTTACAGACTGTTTAAGG -> CTGGACTTACAGACTGTTTAAGGT
GGTTACAAACTTGAACCTCTTAAC -> GTTACAAACTTGAACCTCTTAACG
CACTATCTCGTTACGGAACCGGAA -> ACTATCTCGTTACGGAACCGGAAC
GAAACGACATGACTCCAATCAGGT -> AAACGACATGACTCCAATCAGGTG
TACAGCCGGGTTGAATATAATGCC -> ACAGCCGGGTTGAATATAATGCCA
ATTGTGAGGGCGTCAATATCCTGG -> TTGTGAGGGCGTCAATATCCTGGA
AAAACGCAATTAGGCGGGAGCGCC -> AAACGCAATTAGGCGGGAGCGCCA
TGGAGATGCCGTCGCTCCGGAACG -> GGAGATGCCGTCGCTCCGGAACGG
ACCTCCCGGACTGTAGTAACTCCT -> CCTCCCGGACTGTAGTAACTCCTG
CTTCTGTGGTAACTAGAGTCCATA -> TTCTGTGGTAACTAGAGTCCATAA
CGTGGTACAACCTCCCGGACTGTA -> GTGGTACAACCTCCCGGACTGTAG
TCCCAAGCCATACTCCGCTTCTCC -> CCCAAGCCATACTCCGCTTCTCCC
TAGAGATGAGGATCGGCACGTGGT -> AGAGATGAGGATCGGCACGTGGTG
GCGCATGGCACCTTTAGACTCCCG -> CGCATGGCACCTTTAGACTCCCGA
CCAATATACTTAGGCGTAAGAGAG -> CAATATACTTAGGCGTAAGAGAGC
CTCTACAGCCGGCCTTTGGAAACT -> TCTACAGCCGGCCTTTGGAAACTG
CGGAACGGGTCTACGGCCACGATA -> GGAACGGGTCTACGGCCACGATAA
GATAATCCAGTCATGCTGGGGTCG -> ATAATCCAGTCATGCTGGGGTCGG
CGGGAGCGCCACAGTTGAATTGAT -> GGGAGCGCCACAGTTGAATTGATA
AAACATGTTCTTCGTTATTACAAT -> AACATGTTCTTCGTTATTACAATA
CGGGCGAGTCCGGCATGTTAGAGC -> GGGCGAGTCCGGCATGTTAGAGCA
CTGTGGTAACTAGAGTCCATAAAC -> TGTGGTAACTAGAGTCCATAAACA
CTTAGAGCAGTAAAAACGCAATTA -> TTAGAGCAGTAAAAACGCAATTAG
TTTCAAAGGCCACTATACGCCCGG -> TTCAAAGGCCACTATACGCCCGGT
GCTCGAATAGCATAAATTCGAACA -> CTCGAATAGCATAAATTCGAACAC
CCTTGTCTGGGACGAAGTCGGCCT -> CTTGTCTGGGACGAAGTCGGCCTT
TTCTCTTGGACACTTGTTACGAGC -> TCTCTTGGACACTTGTTACGAGCA
ATGGATGTTACTAGACGCGAATGT -> TGGATGTTACTAGACGCGAATGTC
TCTCGTTACGGAACCGGAACGTAG -> CTCGTTACGGAACCGGAACGTAGA
TGCCCTGTAAAGTAAGAGATCCGG -> GCCCTGTAAAGTAAGAGATCCGGA
GCCTCATCTTTCCGGGCGAGTCCG -> CCTCATCTTTCCGGGCGAGTCCGG
CGTCACTAGTGATGTGTCCTGTGT -> GTCACTAGTGATGTGTCCTGTGTC
CCGGAACGTAGAAGGTAATACCCC -> CGGAACGTAGAAGGTAATACCCCA
TTCGAATTTTCAAGGGTCTTCATA -> TCGAATTTTCAAGGGTCTTCATAA
GTAATACCCCAAGGCTGGCGCGAT -> TAATACCCCAAGGCTGGCGCGATA
TTTTCAAGGGTCTTCATAAGTGTC -> TTTCAAGGGTCTTCATAAGTGTCT
AGGCCACATGCTGCATCCTGATGT -> GGCCACATGCTGCATCCTGATGTG
GCTGGCGGCTCCTGACGCTAACTT -> CTGGCGGCTCCTGACGCTAACTTA
GGCCTGCTCGCCAACTCGCCAATT -> GCCTGCTCGCCAACTCGCCAATTC
CATCAGTGAATTTTGTCGATCAGG -> ATCAGTGAATTTTGTCGATCAGGG
CAAGGCTGGCGCGATAGTAGATGA -> AAGGCTGGCGCGATAGTAGATGAG
CGCCCGTTCTTCTGTGGTAACTAG -> GCCCGTTCTTCTGTGGTAACTAGA
GCAGGGTGCTGTTAAAGCTGGTCG -> CAGGGTGCTGTTAAAGCTGGTCGA
ATAAGTACGCTTCACCCTATGCAC -> TAAGTACGCTTCACCCTATGCACC
TACATTTACAGCCGGGTTGAATAT -> ACATTTACAGCCGGGTTGAATATA
GCCAATTCCGTTTAAGTCGCCAAG -> CCAATTCCGTTTAAGTCGCCAAGA
CCCCATTCCCATCAACCTTGCTTT -> CCCATTCCCATCAACCTTGCTTTA
TGCTTTTTTAGCACACATGTATTC -> GCTTTTTTAGCACACATGTATTCT
GTGGGACCACTATGAACCATTTCA -> TGGGACCACTATGAACCATTTCAA
TCTTAACGGTTCAAGAGCTAACCC -> CTTAACGGTTCAAGAGCTAACCCC
AGAGACCGCCGTCAAACCGATATA -> GAGACCGCCGTCAAACCGATATAT
AACTGCTCGTTCTCTGCTTTAAAT -> ACTGCTCGTTCTCTGCTTTAAATG
GTAAGAGAGCTTACCCTATCTACA -> TAAGAGAGCTTACCCTATCTACAT
CGACCGAGCGCATGGCACCTTTAG -> GACCGAGCGCATGGCACCTTTAGA
GATTGTGAGGATAAACCCTACAGC -> ATTGTGAGGATAAACCCTACAGCA
AGAGCTAACCCCCCAATATACTTA -> GAGCTAACCCCCCAATATACTTAG
TGAAATGAAATTCCTAATCCCAAG -> GAAATGAAATTCCTAATCCCAAGC
GGCTTAGGGTTTCACTATCTCGTT -> GCTTAGGGTTTCACTATCTCGTTA
GTCCATGAGAACGCCTCATCTTTC -> TCCATGAGAACGCCTCATCTTTCC
TGCCTCTACAGCCGGCCTTTGGAA -> GCCTCTACAGCCGGCCTTTGGAAA
AGAGATCCGGATTGTGAGGGCGTC -> GAGATCCGGATTGTGAGGGCGTCA
CCGCTCATGGTACGACCGAGCGCA -> CGCTCATGGTACGACCGAGCGCAT
CCATGAGAACGCCTCATCTTTCCG -> CATGAGAACGCCTCATCTTTCCGG
AGTGAAGGCCTATCCGAAACGACA -> GTGAAGGCCTATCCGAAACGACAT
CCGGCATGTTAGAGCACAGAAGAA -> CGGCATGTTAGAGCACAGAAGAAT
CACAACGTCCCAACTAGAGACCGC -> ACAACGTCCCAACTAGAGACCGCC
ACGCTGGCGGCTCCTGACGCTAAC -> CGCTGGCGGCTCCTGACGCTAACT
ACAGAAGTCGGCATGCCTGGCTTA -> CAGAAGTCGGCATGCCTGGCTTAG
AGCCATTGACGCCATACGTCCGTG -> GCCATTGACGCCATACGTCCGTGC
TGACGCCATACGTCCGTGCTTCGC -> GACGCCATACGTCCGTGCTTCGCC
CTGTAAAGTAAGAGATCCGGATTG -> TGTAAAGTAAGAGATCCGGATTGT
GCCCGTAAAAGCATCTTCACGTAT -> CCCGTAAAAGCATCTTCACGTATC
GGTCGTCTGGTCGACAAATCTCCG -> GTCGTCTGGTCGACAAATCTCCGT
CAAGCCATACTCCGCTTCTCCCCC -> AAGCCATACTCCGCTTCTCCCCCC
ATCTTCACGTATCTGTAGAACATT -> TCTTCACGTATCTGTAGAACATTG
TCTAGTTCCCTGTGCATCAGTGAA -> CTAGTTCCCTGTGCATCAGTGAAT
TGGTCGCTCCGTACAAGCCCATTG -> GGTCGCTCCGTACAAGCCCATTGG
TAAAGACTTATAGTGTCTTCACGT -> AAAGACTTATAGTGTCTTCACGTC
ACTCCCTCAAGTCTAGGGAATTAT -> CTCCCTCAAGTCTAGGGAATTATC
CCTGGCTTAGGGTTTCACTATCTC -> CTGGCTTAGGGTTTCACTATCTCG
GCCGTCAAACCGATATATATTCGC -> CCGTCAAACCGATATATATTCGCT
GATATATATTCGCTCAGCCAGAAG -> ATATATATTCGCTCAGCCAGAAGA
GTTCAAGAGCTAACCCCCCAATAT -> TTCAAGAGCTAACCCCCCAATATA
CCCTAAGCTTCCAAGTGACATGAC -> CCTAAGCTTCCAAGTGACATGACC
TTTCACTATCTCGTTACGGAACCG -> TTCACTATCTCGTTACGGAACCGG
GTGCTTGACCACCTTAGCATAAGT -> TGCTTGACCACCTTAGCATAAGTA
GCACACATGTATTCTGTCAACCGG -> CACACATGTATTCTGTCAACCGGG
TCCTCACCCGATAGGACGGCGATC -> CCTCACCCGATAGGACGGCGATCA
TCGCCAACTCGCCAATTCCGTTTA -> CGCCAACTCGCCAATTCCGTTTAA
GAGTCCGGCATGTTAGAGCACAGA -> AGTCCGGCATGTTAGAGCACAGAA
TGCGGTGTGCTTGACCACCTTAGC -> GCGGTGTGCTTGACCACCTTAGCA
AACTTCAAGCCGTGTGACTTCGTT -> ACTTCAAGCCGTGTGACTTCGTTC
AGCTTCCAAGTGACATGACCTTGA -> GCTTCCAAGTGACATGACCTTGAG
AAGGTAATACCCCAAGGCTGGCGC -> AGGTAATACCCCAAGGCTGGCGCG
GCCGGGTTGAATATAATGCCACAA -> CCGGGTTGAATATAATGCCACAAC
AAAGCATCTTCACGTATCTGTAGA -> AAGCATCTTCACGTATCTGTAGAA
TAACTGAAATGAAATTCCTAATCC -> AACTGAAATGAAATTCCTAATCCC
ATTCTCTTGGACACTTGTTACGAG -> TTCTCTTGGACACTTGTTACGAGC
GTCCCAACTAGAGACCGCCGTCAA -> TCCCAACTAGAGACCGCCGTCAAA
TTCGCCCGTTCTTCTGTGGTAACT -> TCGCCCGTTCTTCTGTGGTAACTA
GACATGACCTTGAGGTCGTCTGGT -> ACATGACCTTGAGGTCGTCTGGTC
TTTGGAAACTGCTCGTTCTCTGCT -> TTGGAAACTGCTCGTTCTCTGCTT
ATGTGTCCTGTGTCAGCAACACTT -> TGTGTCCTGTGTCAGCAACACTTG
TGTCGTTTGCGCCCTTGGTGCCTC -> GTCGTTTGCGCCCTTGGTGCCTCT
GAGCTTACCCTATCTACATTTACA -> AGCTTACCCTATCTACATTTACAG
TACGTGGCCGTGTTCACATGGATG -> ACGTGGCCGTGTTCACATGGATGT
CAGCCGGGTTGAATATAATGCCAC -> AGCCGGGTTGAATATAATGCCACA
CTGCTCGTTCTCTGCTTTAAATGT -> TGCTCGTTCTCTGCTTTAAATGTT
CAGACTGTTTAAGGTTACTACCGC -> AGACTGTTTAAGGTTACTACCGCG
CAGGGTGTAGTCGCCTCCTCACCC -> AGGGTGTAGTCGCCTCCTCACCCG
GCCAACTCGCCAATTCCGTTTAAG -> CCAACTCGCCAATTCCGTTTAAGT
CCGCGACAGCTTTTCGTAACATTT -> CGCGACAGCTTTTCGTAACATTTC
GTGTCCTGTGTCAGCAACACTTGG -> TGTCCTGTGTCAGCAACACTTGGA
GCGTCAATATCCTGGACTTACAGA -> CGTCAATATCCTGGACTTACAGAC
GTGAATTTTGTCGATCAGGGTGTA -> TGAATTTTGTCGATCAGGGTGTAG
CTTCTCCCCCCCCTTTCGAATTTT -> TTCTCCCCCCCCTTTCGAATTTTC
ACGTCCAATACGGACGTTTGTTGT -> CGTCCAATACGGACGTTTGTTGTA
TGTAGTAACTCCTGGTCGCTCCGT -> GTAGTAACTCCTGGTCGCTCCGTA
AAGCTGGTCGAGTGAAGGCCTATC -> AGCTGGTCGAGTGAAGGCCTATCC
GGCGACTGATAACACTTGCAACTG -> GCGACTGATAACACTTGCAACTGA
GACAAATCTCCGTAACTTCAAGCC -> ACAAATCTCCGTAACTTCAAGCCG
TCCGGATTGTGAGGGCGTCAATAT -> CCGGATTGTGAGGGCGTCAATATC
AATATAGAGATGAGGATCGGCACG -> ATATAGAGATGAGGATCGGCACGT
GAAAGTCCGCCGGCGACTGATAAC -> AAAGTCCGCCGGCGACTGATAACA
CAGCCATTGACGCCATACGTCCGT -> AGCCATTGACGCCATACGTCCGTG
GGACGAAGTCGGCCTTATTCCCTC -> GACGAAGTCGGCCTTATTCCCTCG
TATATTCGCTCAGCCAGAAGATTG -> ATATTCGCTCAGCCAGAAGATTGT
ATACTTAGGCGTAAGAGAGCTTAC -> TACTTAGGCGTAAGAGAGCTTACC
CCATAAACATGTTCTTCGTTATTA -> CATAAACATGTTCTTCGTTATTAC
TCTCCGTAACTTCAAGCCGTGTGA -> CTCCGTAACTTCAAGCCGTGTGAC
CACCTTTAGACTCCCGACAGCCCG -> ACCTTTAGACTCCCGACAGCCCGT
TCTACGGCCACGATAATCCAGTCA -> CTACGGCCACGATAATCCAGTCAT
ACTTCAAGCCGTGTGACTTCGTTC -> CTTCAAGCCGTGTGACTTCGTTCC
AGACGCGAATGTCGTTTGCGCCCT -> GACGCGAATGTCGTTTGCGCCCTT
TGATAAACGGTGAAGCTTACAGCC -> GATAAACGGTGAAGCTTACAGCCA
TCGAAGCAGCGGTCTGTCAGTGGT -> CGAAGCAGCGGTCTGTCAGTGGTG
GCCATACGTCCGTGCTTCGCCCGT -> CCATACGTCCGTGCTTCGCCCGTT
ACATGCTGCATCCTGATGTGTCAT -> CATGCTGCATCCTGATGTGTCATA
AGCTCTACGTGGCCGTGTTCACAT -> GCTCTACGTGGCCGTGTTCACATG
TGTCTGGGACGAAGTCGGCCTTAT -> GTCTGGGACGAAGTCGGCCTTATT
TTGCGGTGTGCTTGACCACCTTAG -> TGCGGTGTGCTTGACCACCTTAGC
AGTCGCCAAGATCTATACCCTTGT -> GTCGCCAAGATCTATACCCTTGTC
GTTTAAGTCGCCAAGATCTATACC -> TTTAAGTCGCCAAGATCTATACCC
GCGCCACAGTTGAATTGATAAACG -> CGCCACAGTTGAATTGATAAACGG
TCGGCAGGGTGCTGTTAAAGCTGG -> CGGCAGGGTGCTGTTAAAGCTGGT
GAACCTCTTAACGGTTCAAGAGCT -> AACCTCTTAACGGTTCAAGAGCTA
GTTGAATATAATGCCACAACAGAA -> TTGAATATAATGCCACAACAGAAG
GTCGTCTGGTCGACAAATCTCCGT -> TCGTCTGGTCGACAAATCTCCGTA
GCCCCATTCCCATCAACCTTGCTT -> CCCCATTCCCATCAACCTTGCTTT
CCGGGCGAGTCCGGCATGTTAGAG -> CGGGCGAGTCCGGCATGTTAGAGC
ATTAAAAGCGCTGCCCTGTAAAGT -> TTAAAAGCGCTGCCCTGTAAAGTA
TGCAAGCTTAGCAGGCCACATGCT -> GCAAGCTTAGCAGGCCACATGCTG
TTCCTAATCCCAAGCCATACTCCG -> TCCTAATCCCAAGCCATACTCCGC
CGTCAAACCGATATATATTCGCTC -> GTCAAACCGATATATATTCGCTCA
CAGAAGAATTCTCGAAGCAGCGGT -> AGAAGAATTCTCGAAGCAGCGGTC
TTGCGCCCTTGGTGCCTCTACAGC -> TGCGCCCTTGGTGCCTCTACAGCC
CAAGCCGTGTGACTTCGTTCCCCC -> AAGCCGTGTGACTTCGTTCCCCCA
TCCCCCACATCGCTAAAGACTTAT -> CCCCCACATCGCTAAAGACTTATA
CGTGGTGGGACCACTATGAACCAT -> GTGGTGGGACCACTATGAACCATT
ACTTTCGAAAGCGATCCAACCTAG -> CTTTCGAAAGCGATCCAACCTAGA
CGAACACGACCGCTCATGGTACGA -> GAACACGACCGCTCATGGTACGAC
TATTTCTAGTTCCCTGTGCATCAG -> ATTTCTAGTTCCCTGTGCATCAGT
TACAGCACAACGTCCCAACTAGAG -> ACAGCACAACGTCCCAACTAGAGA
CTCGAATAGCATAAATTCGAACAC -> TCGAATAGCATAAATTCGAACACG
AGCAGCGGTCTGTCAGTGGTGTGC -> GCAGCGGTCTGTCAGTGGTGTGCT
ACAGCACAACGTCCCAACTAGAGA -> CAGCACAACGTCCCAACTAGAGAC
TTCAACACAGATAATTCTCTTGGA -> TCAACACAGATAATTCTCTTGGAC
CGGGTTGAATATAATGCCACAACA -> GGGTTGAATATAATGCCACAACAG
TAGAAGTCTGAATTTAGGGGGTTA -> AGAAGTCTGAATTTAGGGGGTTAC
AGCCAGAAGATTGTATGCGGCCCC -> GCCAGAAGATTGTATGCGGCCCCA
TTTCGTAACATTTCTCCGACGCCG -> TTCGTAACATTTCTCCGACGCCGA
CCCAATATACTTAGGCGTAAGAGA -> CCAATATACTTAGGCGTAAGAGAG
TAGCATAAATTCGAACACGACCGC -> AGCATAAATTCGAACACGACCGCT
TCTGTGGTAACTAGAGTCCATAAA -> CTGTGGTAACTAGAGTCCATAAAC
CGGCCCCATTCCCATCAACCTTGC -> GGCCCCATTCCCATCAACCTTGCT
ATCCTGATGTGTCATACCAATAGA -> TCCTGATGTGTCATACCAATAGAA
TGTGGTAACTAGAGTCCATAAACA -> GTGGTAACTAGAGTCCATAAACAT
TAATACCCCAAGGCTGGCGCGATA -> AATACCCCAAGGCTGGCGCGATAG
CCTCGCAAATGAATATAGAGATGA -> CTCGCAAATGAATATAGAGATGAG
CCTAAGCTTCCAAGTGACATGACC -> CTAAGCTTCCAAGTGACATGACCT
CCGGATTGTGAGGGCGTCAATATC -> CGGATTGTGAGGGCGTCAATATCC
ATGAATATAGAGATGAGGATCGGC -> TGAATATAGAGATGAGGATCGGCA
CCCCCCAATATACTTAGGCGTAAG -> CCCCCAATATACTTAGGCGTAAGA
TAGAGACCGCCGTCAAACCGATAT -> AGAGACCGCCGTCAAACCGATATA
TAAGTACGCTTCACCCTATGCACC -> AAGTACGCTTCACCCTATGCACCC
GCCTGCTCGCCAACTCGCCAATTC -> CCTGCTCGCCAACTCGCCAATTCC
AATTAGGCGGGAGCGCCACAGTTG -> ATTAGGCGGGAGCGCCACAGTTGA
TTCACCCTATGCACCCGTGGTACA -> TCACCCTATGCACCCGTGGTACAA
GGTTACTACCGCGACAGCTTTTCG -> GTTACTACCGCGACAGCTTTTCGT
GTGAGGATAAACCCTACAGCACAA -> TGAGGATAAACCCTACAGCACAAC
ACTATACGCCCGGTAGAAGTCTGA -> CTATACGCCCGGTAGAAGTCTGAA
GGAACCGGAACGTAGAAGGTAATA -> GAACCGGAACGTAGAAGGTAATAC
GTTCTCTGCTTTAAATGTTAGCCG -> TTCTCTGCTTTAAATGTTAGCCGG
AATATCCTGGACTTACAGACTGTT -> ATATCCTGGACTTACAGACTGTTT
TAACTTCAAGCCGTGTGACTTCGT -> AACTTCAAGCCGTGTGACTTCGTT
GGATAAACCCTACAGCACAACGTC -> GATAAACCCTACAGCACAACGTCC
TAACGGTTCAAGAGCTAACCCCCC -> AACGGTTCAAGAGCTAACCCCCCA
GCGACTGATAACACTTGCAACTGA -> CGACTGATAACACTTGCAACTGAA
CTGAATTTAGGGGGTTACAAACTT -> TGAATTTAGGGGGTTACAAACTTG
AGTAGATGAGTGCAATATGAAGTC -> GTAGATGAGTGCAATATGAAGTCG
GGCCCCATTCCCATCAACCTTGCT -> GCCCCATTCCCATCAACCTTGCTT
TGCAATATGAAGTCGGCAGGGTGC -> GCAATATGAAGTCGGCAGGGTGCT
GCATCCTGATGTGTCATACCAATA -> CATCCTGATGTGTCATACCAATAG
AGTCTAGGGAATTATCGTCACTAG -> GTCTAGGGAATTATCGTCACTAGT
GAAGCAGCGGTCTGTCAGTGGTGT -> AAGCAGCGGTCTGTCAGTGGTGTG
GCACAGAAGAATTCTCGAAGCAGC -> CACAGAAGAATTCTCGAAGCAGCG
TCACTATCTCGTTACGGAACCGGA -> CACTATCTCGTTACGGAACCGGAA
CAAGAGCTAACCCCCCAATATACT -> AAGAGCTAACCCCCCAATATACTT
CTAGAGACCGCCGTCAAACCGATA -> TAGAGACCGCCGTCAAACCGATAT
CTGGGACGAAGTCGGCCTTATTCC -> TGGGACGAAGTCGGCCTTATTCCC
TTAAATGTTAGCCGGTTTGAACGC -> TAAATGTTAGCCGGTTTGAACGCC
TCGATCAGGGTGTAGTCGCCTCCT -> CGATCAGGGTGTAGTCGCCTCCTC
ATGCGGCCCCATTCCCATCAACCT -> TGCGGCCCCATTCCCATCAACCTT
CGTGTGACTTCGTTCCCCCACATC -> GTGTGACTTCGTTCCCCCACATCG
ACGTCCCAACTAGAGACCGCCGTC -> CGTCCCAACTAGAGACCGCCGTCA
TTTATCCTCTTAGTGATTGTATTT -> TTATCCTCTTAGTGATTGTATTTC
AGTGCAATATGAAGTCGGCAGGGT -> GTGCAATATGAAGTCGGCAGGGTG
GCTCGTTCTCTGCTTTAAATGTTA -> CTCGTTCTCTGCTTTAAATGTTAG
ATACGCCCGGTAGAAGTCTGAATT -> TACGCCCGGTAGAAGTCTGAATTT
CTGCTTTAAATGTTAGCCGGTTTG -> TGCTTTAAATGTTAGCCGGTTTGA
ACCGGAACGTAGAAGGTAATACCC -> CCGGAACGTAGAAGGTAATACCCC
GTTCCCCCACATCGCTAAAGACTT -> TTCCCCCACATCGCTAAAGACTTA
GAAACTGCTCGTTCTCTGCTTTAA -> AAACTGCTCGTTCTCTGCTTTAAA
ACCTCTTAACGGTTCAAGAGCTAA -> CCTCTTAACGGTTCAAGAGCTAAC
CAGTGAATTTTGTCGATCAGGGTG -> AGTGAATTTTGTCGATCAGGGTGT
ACATGACCTTGAGGTCGTCTGGTC -> CATGACCTTGAGGTCGTCTGGTCG
CTTTTCGTAACATTTCTCCGACGC -> TTTTCGTAACATTTCTCCGACGCC
ATAATGCCACAACAGAAGTCGGCA -> TAATGCCACAACAGAAGTCGGCAT
CCGCTTCTCCCCCCCCTTTCGAAT -> CGCTTCTCCCCCCCCTTTCGAATT
ATATTCGCTCAGCCAGAAGATTGT -> TATTCGCTCAGCCAGAAGATTGTA
CAGCGGTCTGTCAGTGGTGTGCTC -> AGCGGTCTGTCAGTGGTGTGCTCG
AACCCTACAGCACAACGTCCCAAC -> ACCCTACAGCACAACGTCCCAACT
TGTTAAAGCTGGTCGAGTGAAGGC -> GTTAAAGCTGGTCGAGTGAAGGCC
GCTGCCCTGTAAAGTAAGAGATCC -> CTGCCCTGTAAAGTAAGAGATCCG
GACCTTGAGGTCGTCTGGTCGACA -> ACCTTGAGGTCGTCTGGTCGACAA
ATGCACCCGTGGTACAACCTCCCG -> TGCACCCGTGGTACAACCTCCCGG
TGTCATACCAATAGAAAAATCAGA -> GTCATACCAATAGAAAAATCAGAG
GTCTATACAGGATTGCGGTGTGCT -> TCTATACAGGATTGCGGTGTGCTT
AACCTCCCGGACTGTAGTAACTCC -> ACCTCCCGGACTGTAGTAACTCCT
GCATCAGTGAATTTTGTCGATCAG -> CATCAGTGAATTTTGTCGATCAGG
CCGGAACGGGTCTACGGCCACGAT -> CGGAACGGGTCTACGGCCACGATA
AGTGTCTTCACGTCCATGAGAACG -> GTGTCTTCACGTCCATGAGAACGC
ATGTTCTTCGTTATTACAATACTC -> TGTTCTTCGTTATTACAATACTCC
GGAAGTGCGATACCGTGGCCGGTC -> GAAGTGCGATACCGTGGCCGGTCA
GTCATGCTGGGGTCGGGCCTGCTC -> TCATGCTGGGGTCGGGCCTGCTCG
TTCTGTCAACCGGGATGTACGCTG -> TCTGTCAACCGGGATGTACGCTGG
CAAGCTTAGCAGGCCACATGCTGC -> AAGCTTAGCAGGCCACATGCTGCA
CGACGCCGATTGTGAGGATAAACC -> GACGCCGATTGTGAGGATAAACCC
TAGCACACATGTATTCTGTCAACC -> AGCACACATGTATTCTGTCAACCG
CGAAACGACATGACTCCAATCAGG -> GAAACGACATGACTCCAATCAGGT
AATACTCCCTCAAGTCTAGGGAAT -> ATACTCCCTCAAGTCTAGGGAATT
TTATCGTCACTAGTGATGTGTCCT -> TATCGTCACTAGTGATGTGTCCTG
ACCATTTCAAAGGCCACTATACGC -> CCATTTCAAAGGCCACTATACGCC
GTTCTTCGTTATTACAATACTCCC -> TTCTTCGTTATTACAATACTCCCT
TGTTAGCCGGTTTGAACGCCGAAA -> GTTAGCCGGTTTGAACGCCGAAAG
AATTTTGTCGATCAGGGTGTAGTC -> ATTTTGTCGATCAGGGTGTAGTCG
AAGGGTCTTCATAAGTGTCTATAC -> AGGGTCTTCATAAGTGTCTATACA
AAGCCGTGTGACTTCGTTCCCCCA -> AGCCGTGTGACTTCGTTCCCCCAC
GCAGCGGTCTGTCAGTGGTGTGCT -> CAGCGGTCTGTCAGTGGTGTGCTC
GTCGCCTCCTCACCCGATAGGACG -> TCGCCTCCTCACCCGATAGGACGG
TCCTGGACTTACAGACTGTTTAAG -> CCTGGACTTACAGACTGTTTAAGG
CGCCAACTCGCCAATTCCGTTTAA -> GCCAACTCGCCAATTCCGTTTAAG
CCGCCGGCGACTGATAACACTTGC -> CGCCGGCGACTGATAACACTTGCA
TACGGAACCGGAACGTAGAAGGTA -> ACGGAACCGGAACGTAGAAGGTAA
TGAAGCTTACAGCCATTGACGCCA -> GAAGCTTACAGCCATTGACGCCAT
AGGGCGTCAATATCCTGGACTTAC -> GGGCGTCAATATCCTGGACTTACA
GATGCCGTCGCTCCGGAACGGGTC -> ATGCCGTCGCTCCGGAACGGGTCT
GTTGAATTGATAAACGGTGAAGCT -> TTGAATTGATAAACGGTGAAGCTT
TTCGAACACGACCGCTCATGGTAC -> TCGAACACGACCGCTCATGGTACG
ACCAATAGAAAAATCAGAGCATCC -> CCAATAGAAAAATCAGAGCATCCC
TAAGCTTCCAAGTGACATGACCTT -> AAGCTTCCAAGTGACATGACCTTG
ATGAAATTCCTAATCCCAAGCCAT -> TGAAATTCCTAATCCCAAGCCATA
AACATTGGAAGACCTCGCAAATGA -> ACATTGGAAGACCTCGCAAATGAA
ACTTATAGTGTCTTCACGTCCATG -> CTTATAGTGTCTTCACGTCCATGA
GACGTTTGTTGTAACTGAAATGAA -> ACGTTTGTTGTAACTGAAATGAAA
GCATGTTAGAGCACAGAAGAATTC -> CATGTTAGAGCACAGAAGAATTCT
TCTTCACGTCCATGAGAACGCCTC -> CTTCACGTCCATGAGAACGCCTCA
GTTAGAGCACAGAAGAATTCTCGA -> TTAGAGCACAGAAGAATTCTCGAA
AAGCCGGTACGTCCAATACGGACG -> AGCCGGTACGTCCAATACGGACGT
TCCCTCGTTCAACACAGATAATTC -> CCCTCGTTCAACACAGATAATTCT
TGCCACAACAGAAGTCGGCATGCC -> GCCACAACAGAAGTCGGCATGCCT
TCTACGTGGCCGTGTTCACATGGA -> CTACGTGGCCGTGTTCACATGGAT
CAGGATTGCGGTGTGCTTGACCAC -> AGGATTGCGGTGTGCTTGACCACC
TGGCCGTGTTCACATGGATGTTAC -> GGCCGTGTTCACATGGATGTTACT
TCCGCTTCTCCCCCCCCTTTCGAA -> CCGCTTCTCCCCCCCCTTTCGAAT
TCATACCAATAGAAAAATCAGAGC -> CATACCAATAGAAAAATCAGAGCA
GAGCGCCACAGTTGAATTGATAAA -> AGCGCCACAGTTGAATTGATAAAC
CGGAACGTAGAAGGTAATACCCCA -> GGAACGTAGAAGGTAATACCCCAA
CGTGCTTCGCCCGTTCTTCTGTGG -> GTGCTTCGCCCGTTCTTCTGTGGT
TACAAGCCCATTGGAGATGCCGTC -> ACAAGCCCATTGGAGATGCCGTCG
GGTGTGCTCGAATAGCATAAATTC -> GTGTGCTCGAATAGCATAAATTCG
CGGTAGAAGTCTGAATTTAGGGGG -> GGTAGAAGTCTGAATTTAGGGGGT
TAAATGTTAGCCGGTTTGAACGCC -> AAATGTTAGCCGGTTTGAACGCCG
TAAAAGCGCTGCCCTGTAAAGTAA -> AAAAGCGCTGCCCTGTAAAGTAAG
GGGTGTAGTCGCCTCCTCACCCGA -> GGTGTAGTCGCCTCCTCACCCGAT
GTGACTTCGTTCCCCCACATCGCT -> TGACTTCGTTCCCCCACATCGCTA
CTGTCAGTGGTGTGCTCGAATAGC -> TGTCAGTGGTGTGCTCGAATAGCA
ACTTGCAACTGAACTTTCGAAAGC -> CTTGCAACTGAACTTTCGAAAGCG
CAATACTCCCTCAAGTCTAGGGAA -> AATACTCCCTCAAGTCTAGGGAAT
TACGAGCAGCTCTACGTGGCCGTG -> ACGAGCAGCTCTACGTGGCCGTGT
CTATCCGAAACGACATGACTCCAA -> TATCCGAAACGACATGACTCCAAT
GAACTTTCGAAAGCGATCCAACCT -> AACTTTCGAAAGCGATCCAACCTA
TCTAGGGAATTATCGTCACTAGTG -> CTAGGGAATTATCGTCACTAGTGA
CTGATAACACTTGCAACTGAACTT -> TGATAACACTTGCAACTGAACTTT
ATCAACCTTGCTTTATCCTCTTAG -> TCAACCTTGCTTTATCCTCTTAGT
GCCCATTGGAGATGCCGTCGCTCC -> CCCATTGGAGATGCCGTCGCTCCG
CGCCCTTGGTGCCTCTACAGCCGG -> GCCCTTGGTGCCTCTACAGCCGGC
GAATGTCGTTTGCGCCCTTGGTGC -> AATGTCGTTTGCGCCCTTGGTGCC
ACAACCTCCCGGACTGTAGTAACT -> CAACCTCCCGGACTGTAGTAACTC
TGAGGATCGGCACGTGGTGGGACC -> GAGGATCGGCACGTGGTGGGACCA
GGTTTGAACGCCGAAAGTCCGCCG -> GTTTGAACGCCGAAAGTCCGCCGG
GTAAAGTAAGAGATCCGGATTGTG -> TAAAGTAAGAGATCCGGATTGTGA
CAATATGAAGTCGGCAGGGTGCTG -> AATATGAAGTCGGCAGGGTGCTGT
ATGACTCCAATCAGGTGCTTTTTT -> TGACTCCAATCAGGTGCTTTTTTA
ACCCTACAGCACAACGTCCCAACT -> CCCTACAGCACAACGTCCCAACTA
GTGCTTAGAGCAGTAAAAACGCAA -> TGCTTAGAGCAGTAAAAACGCAAT
GGTCGACAAATCTCCGTAACTTCA -> GTCGACAAATCTCCGTAACTTCAA
ATAGAGATGAGGATCGGCACGTGG -> TAGAGATGAGGATCGGCACGTGGT
GACTTACAGACTGTTTAAGGTTAC -> ACTTACAGACTGTTTAAGGTTACT
GACTGATAACACTTGCAACTGAAC -> ACTGATAACACTTGCAACTGAACT
CTATCTCGTTACGGAACCGGAACG -> TATCTCGTTACGGAACCGGAACGT
CCGACGCCGATTGTGAGGATAAAC -> CGACGCCGATTGTGAGGATAAACC
GTCGGCATGCCTGGCTTAGGGTTT -> TCGGCATGCCTGGCTTAGGGTTTC
AGGTCGTCTGGTCGACAAATCTCC -> GGTCGTCTGGTCGACAAATCTCCG
GTCAATATCCTGGACTTACAGACT -> TCAATATCCTGGACTTACAGACTG
ACCGCGACAGCTTTTCGTAACATT -> CCGCGACAGCTTTTCGTAACATTT
CTGTTTAAGGTTACTACCGCGACA -> TGTTTAAGGTTACTACCGCGACAG
TGCTGCATCCTGATGTGTCATACC -> GCTGCATCCTGATGTGTCATACCA
TCGGCATGCCTGGCTTAGGGTTTC -> CGGCATGCCTGGCTTAGGGTTTCA
CCTCTTAGTGATTGTATTTCTAGT -> CTCTTAGTGATTGTATTTCTAGTT
ACGCCTCATCTTTCCGGGCGAGTC -> CGCCTCATCTTTCCGGGCGAGTCC
GCCGATTGTGAGGATAAACCCTAC -> CCGATTGTGAGGATAAACCCTACA
ATACAGGATTGCGGTGTGCTTGAC -> TACAGGATTGCGGTGTGCTTGACC
CTTAGCAGGCCACATGCTGCATCC -> TTAGCAGGCCACATGCTGCATCCT
AATATAATGCCACAACAGAAGTCG -> ATATAATGCCACAACAGAAGTCGG
GCGATACCGTGGCCGGTCATTAAA -> CGATACCGTGGCCGGTCATTAAAA
ACGAGCAGCTCTACGTGGCCGTGT -> CGAGCAGCTCTACGTGGCCGTGTT
AGTACGCTTCACCCTATGCACCCG -> GTACGCTTCACCCTATGCACCCGT
TCGAGTGAAGGCCTATCCGAAACG -> CGAGTGAAGGCCTATCCGAAACGA
CAATTAGGCGGGAGCGCCACAGTT -> AATTAGGCGGGAGCGCCACAGTTG
TGCACCCGTGGTACAACCTCCCGG -> GCACCCGTGGTACAACCTCCCGGA
TGCGATACCGTGGCCGGTCATTAA -> GCGATACCGTGGCCGGTCATTAAA
CGATACCGTGGCCGGTCATTAAAA -> GATACCGTGGCCGGTCATTAAAAG
CGCCTCCTCACCCGATAGGACGGC -> GCCTCCTCACCCGATAGGACGGCG
GTCGGCCTTATTCCCTCGTTCAAC -> TCGGCCTTATTCCCTCGTTCAACA
GATGTGTCATACCAATAGAAAAAT -> ATGTGTCATACCAATAGAAAAATC
CTCTACGTGGCCGTGTTCACATGG -> TCTACGTGGCCGTGTTCACATGGA
TTAGCACACATGTATTCTGTCAAC -> TAGCACACATGTATTCTGTCAACC
GTAGTAACTCCTGGTCGCTCCGTA -> TAGTAACTCCTGGTCGCTCCGTAC
CATGACTCCAATCAGGTGCTTTTT -> ATGACTCCAATCAGGTGCTTTTTT
TACTAAGCCGGTACGTCCAATACG -> ACTAAGCCGGTACGTCCAATACGG
TGACGCTAACTTACTAAGCCGGTA -> GACGCTAACTTACTAAGCCGGTAC
CTGAACTTTCGAAAGCGATCCAAC -> TGAACTTTCGAAAGCGATCCAACC
CTATACCCTTGTCTGGGACGAAGT -> TATACCCTTGTCTGGGACGAAGTC
ATTGACGCCATACGTCCGTGCTTC -> TTGACGCCATACGTCCGTGCTTCG
AACATTTCTCCGACGCCGATTGTG -> ACATTTCTCCGACGCCGATTGTGA
CGGTGTGCTTGACCACCTTAGCAT -> GGTGTGCTTGACCACCTTAGCATA
AATTATCGTCACTAGTGATGTGTC -> ATTATCGTCACTAGTGATGTGTCC
GTGGCCGGTCATTAAAAGCGCTGC -> TGGCCGGTCATTAAAAGCGCTGCC
GGACCACTATGAACCATTTCAAAG -> GACCACTATGAACCATTTCAAAGG
TCTCCGACGCCGATTGTGAGGATA -> CTCCGACGCCGATTGTGAGGATAA
CCAAGCCATACTCCGCTTCTCCCC -> CAAGCCATACTCCGCTTCTCCCCC
GCCGTGTTCACATGGATGTTACTA -> CCGTGTTCACATGGATGTTACTAG
TTGATAAACGGTGAAGCTTACAGC -> TGATAAACGGTGAAGCTTACAGCC
ACCTCGCAAATGAATATAGAGATG -> CCTCGCAAATGAATATAGAGATGA
CACATCGCTAAAGACTTATAGTGT -> ACATCGCTAAAGACTTATAGTGTC
CACAGAAGAATTCTCGAAGCAGCG -> ACAGAAGAATTCTCGAAGCAGCGG
TGGTCGACAAATCTCCGTAACTTC -> GGTCGACAAATCTCCGTAACTTCA
CAAGGGTCTTCATAAGTGTCTATA -> AAGGGTCTTCATAAGTGTCTATAC
TGTTCACATGGATGTTACTAGACG -> GTTCACATGGATGTTACTAGACGC
GGACTGTAGTAACTCCTGGTCGCT -> GACTGTAGTAACTCCTGGTCGCTC
CTGGCGGCTCCTGACGCTAACTTA -> TGGCGGCTCCTGACGCTAACTTAC
TAGAGCACAGAAGAATTCTCGAAG -> AGAGCACAGAAGAATTCTCGAAGC
CCGGTTTGAACGCCGAAAGTCCGC -> CGGTTTGAACGCCGAAAGTCCGCC
GATTGCGGTGTGCTTGACCACCTT -> ATTGCGGTGTGCTTGACCACCTTA
ACTGTAGTAACTCCTGGTCGCTCC -> CTGTAGTAACTCCTGGTCGCTCCG
CCACATGCTGCATCCTGATGTGTC -> CACATGCTGCATCCTGATGTGTCA
CCACCTTAGCATAAGTACGCTTCA -> CACCTTAGCATAAGTACGCTTCAC
CGATTGTGAGGATAAACCCTACAG -> GATTGTGAGGATAAACCCTACAGC
CGATCCAACCTAGACCCGTGCTTA -> GATCCAACCTAGACCCGTGCTTAG
ATAAGTGTCTATACAGGATTGCGG -> TAAGTGTCTATACAGGATTGCGGT
CCATCAACCTTGCTTTATCCTCTT -> CATCAACCTTGCTTTATCCTCTTA
CACATGGATGTTACTAGACGCGAA -> ACATGGATGTTACTAGACGCGAAT
CTGTGTCAGCAACACTTGGAAGTG -> TGTGTCAGCAACACTTGGAAGTGC
CTCATCTTTCCGGGCGAGTCCGGC -> TCATCTTTCCGGGCGAGTCCGGCA
TCTGGGACGAAGTCGGCCTTATTC -> CTGGGACGAAGTCGGCCTTATTCC
TACGCTGGCGGCTCCTGACGCTAA -> ACGCTGGCGGCTCCTGACGCTAAC
ACTGAACTTTCGAAAGCGATCCAA -> CTGAACTTTCGAAAGCGATCCAAC
CCAACTCGCCAATTCCGTTTAAGT -> CAACTCGCCAATTCCGTTTAAGTC
GACAGCTTTTCGTAACATTTCTCC -> ACAGCTTTTCGTAACATTTCTCCG
CAGCACAACGTCCCAACTAGAGAC -> AGCACAACGTCCCAACTAGAGACC
ATTTCTAGTTCCCTGTGCATCAGT -> TTTCTAGTTCCCTGTGCATCAGTG
ACAAATCTCCGTAACTTCAAGCCG -> CAAATCTCCGTAACTTCAAGCCGT
CGACAAATCTCCGTAACTTCAAGC -> GACAAATCTCCGTAACTTCAAGCC
ATAGCATAAATTCGAACACGACCG -> TAGCATAAATTCGAACACGACCGC
CTTTATCCTCTTAGTGATTGTATT -> TTTATCCTCTTAGTGATTGTATTT
TGCTCGTTCTCTGCTTTAAATGTT -> GCTCGTTCTCTGCTTTAAATGTTA
CAACCTAGACCCGTGCTTAGAGCA -> AACCTAGACCCGTGCTTAGAGCAG
AAACTGCTCGTTCTCTGCTTTAAA -> AACTGCTCGTTCTCTGCTTTAAAT
AGCCGGGTTGAATATAATGCCACA -> GCCGGGTTGAATATAATGCCACAA
GCTCCTGACGCTAACTTACTAAGC -> CTCCTGACGCTAACTTACTAAGCC
GACCTCGCAAATGAATATAGAGAT -> ACCTCGCAAATGAATATAGAGATG
AGGGTGTAGTCGCCTCCTCACCCG -> GGGTGTAGTCGCCTCCTCACCCGA
CGTACAAGCCCATTGGAGATGCCG -> GTACAAGCCCATTGGAGATGCCGT
AGGCTGGCGCGATAGTAGATGAGT -> GGCTGGCGCGATAGTAGATGAGTG
ACTCCTGGTCGCTCCGTACAAGCC -> CTCCTGGTCGCTCCGTACAAGCCC
TGAACTTTCGAAAGCGATCCAACC -> GAACTTTCGAAAGCGATCCAACCT
CAACCGGGATGTACGCTGGCGGCT -> AACCGGGATGTACGCTGGCGGCTC
TAGATGAGTGCAATATGAAGTCGG -> AGATGAGTGCAATATGAAGTCGGC
GAAGAATTCTCGAAGCAGCGGTCT -> AAGAATTCTCGAAGCAGCGGTCTG
GACCACCTTAGCATAAGTACGCTT -> ACCACCTTAGCATAAGTACGCTTC
CATGACCTTGAGGTCGTCTGGTCG -> ATGACCTTGAGGTCGTCTGGTCGA
GGCACGTGGTGGGACCACTATGAA -> GCACGTGGTGGGACCACTATGAAC
ATATACTTAGGCGTAAGAGAGCTT -> TATACTTAGGCGTAAGAGAGCTTA
CTAGGGAATTATCGTCACTAGTGA -> TAGGGAATTATCGTCACTAGTGAT
GCCGGTACGTCCAATACGGACGTT -> CCGGTACGTCCAATACGGACGTTT
CCTGACGCTAACTTACTAAGCCGG -> CTGACGCTAACTTACTAAGCCGGT
CAACACTTGGAAGTGCGATACCGT -> AACACTTGGAAGTGCGATACCGTG
CGGTTCAAGAGCTAACCCCCCAAT -> GGTTCAAGAGCTAACCCCCCAATA
TAAAAGCATCTTCACGTATCTGTA -> AAAAGCATCTTCACGTATCTGTAG
CCCATCAACCTTGCTTTATCCTCT -> CCATCAACCTTGCTTTATCCTCTT
AGGCGTAAGAGAGCTTACCCTATC -> GGCGTAAGAGAGCTTACCCTATCT
GTTCTTCTGTGGTAACTAGAGTCC -> TTCTTCTGTGGTAACTAGAGTCCA
GTGACATGACCTTGAGGTCGTCTG -> TGACATGACCTTGAGGTCGTCTGG
GTGCTGTTAAAGCTGGTCGAGTGA -> TGCTGTTAAAGCTGGTCGAGTGAA
GAACACGACCGCTCATGGTACGAC -> AACACGACCGCTCATGGTACGACC
AATAGCATAAATTCGAACACGACC -> ATAGCATAAATTCGAACACGACCG
AGCCGTGTGACTTCGTTCCCCCAC -> GCCGTGTGACTTCGTTCCCCCACA
GGTACAACCTCCCGGACTGTAGTA -> GTACAACCTCCCGGACTGTAGTAA
AGGGTCTTCATAAGTGTCTATACA -> GGGTCTTCATAAGTGTCTATACAG
GGCGTCAATATCCTGGACTTACAG -> GCGTCAATATCCTGGACTTACAGA
TACAACCTCCCGGACTGTAGTAAC -> ACAACCTCCCGGACTGTAGTAACT
ATTAGGCGGGAGCGCCACAGTTGA -> TTAGGCGGGAGCGCCACAGTTGAA
TGTAGAACATTGGAAGACCTCGCA -> GTAGAACATTGGAAGACCTCGCAA
CGCGATAGTAGATGAGTGCAATAT -> GCGATAGTAGATGAGTGCAATATG
AGCTAACCCCCCAATATACTTAGG -> GCTAACCCCCCAATATACTTAGGC
TAAGCCGGTACGTCCAATACGGAC -> AAGCCGGTACGTCCAATACGGACG
TTCCCATCAACCTTGCTTTATCCT -> TCCCATCAACCTTGCTTTATCCTC
ATGACCTTGAGGTCGTCTGGTCGA -> TGACCTTGAGGTCGTCTGGTCGAC
TGTATTCTGTCAACCGGGATGTAC -> GTATTCTGTCAACCGGGATGTACG
AATTTAGGGGGTTACAAACTTGAA -> ATTTAGGGGGTTACAAACTTGAAC
TCCTAATCCCAAGCCATACTCCGC -> CCTAATCCCAAGCCATACTCCGCT
TTGTATTTCTAGTTCCCTGTGCAT -> TGTATTTCTAGTTCCCTGTGCATC
TAACATTTCTCCGACGCCGATTGT -> AACATTTCTCCGACGCCGATTGTG
AGCGCTGCCCTGTAAAGTAAGAGA -> GCGCTGCCCTGTAAAGTAAGAGAT
GTCGCTCCGTACAAGCCCATTGGA -> TCGCTCCGTACAAGCCCATTGGAG
TCAATATCCTGGACTTACAGACTG -> CAATATCCTGGACTTACAGACTGT
AAAGCTGGTCGAGTGAAGGCCTAT -> AAGCTGGTCGAGTGAAGGCCTATC
ACCGATATATATTCGCTCAGCCAG -> CCGATATATATTCGCTCAGCCAGA
ACCCTATCTACATTTACAGCCGGG -> CCCTATCTACATTTACAGCCGGGT
CTCCCTCAAGTCTAGGGAATTATC -> TCCCTCAAGTCTAGGGAATTATCG
CCTGTGCATCAGTGAATTTTGTCG -> CTGTGCATCAGTGAATTTTGTCGA
ATTTTGTCGATCAGGGTGTAGTCG -> TTTTGTCGATCAGGGTGTAGTCGC
CAACCTTGCTTTATCCTCTTAGTG -> AACCTTGCTTTATCCTCTTAGTGA
TGAATTGATAAACGGTGAAGCTTA -> GAATTGATAAACGGTGAAGCTTAC
AGCCGGTACGTCCAATACGGACGT -> GCCGGTACGTCCAATACGGACGTT
TCAGCAACACTTGGAAGTGCGATA -> CAGCAACACTTGGAAGTGCGATAC
AATGAAATTCCTAATCCCAAGCCA -> ATGAAATTCCTAATCCCAAGCCAT
TATCCTGGACTTACAGACTGTTTA -> ATCCTGGACTTACAGACTGTTTAA
GCCACTATACGCCCGGTAGAAGTC -> CCACTATACGCCCGGTAGAAGTCT
CTATGCACCCGTGGTACAACCTCC -> TATGCACCCGTGGTACAACCTCCC
AATTTTCAAGGGTCTTCATAAGTG -> ATTTTCAAGGGTCTTCATAAGTGT
AGCACACATGTATTCTGTCAACCG -> GCACACATGTATTCTGTCAACCGG
TGCGGCCCCATTCCCATCAACCTT -> GCGGCCCCATTCCCATCAACCTTG
AAGACCTCGCAAATGAATATAGAG -> AGACCTCGCAAATGAATATAGAGA
TCCGTACAAGCCCATTGGAGATGC -> CCGTACAAGCCCATTGGAGATGCC
CCCGGACTGTAGTAACTCCTGGTC -> CCGGACTGTAGTAACTCCTGGTCG
CGTTCTCTGCTTTAAATGTTAGCC -> GTTCTCTGCTTTAAATGTTAGCCG
TGTCCTGTGTCAGCAACACTTGGA -> GTCCTGTGTCAGCAACACTTGGAA
ATAGAAAAATCAGAGCATCCCTAA -> TAGAAAAATCAGAGCATCCCTAAG
